GJRED1	શિવજીની\N_NNP બે\QT_QTC અવસ્થાઓ\N_NN માનવામાં\V_VAUX_VNP આવી\V_VAUX છે\V_VAUX .\RD_PUNC
GJRED2	તેમાંથી\DM_DMD એક\QT_QTC સમાધિ\N_NN અને\CC_CCD બીજી\JJ તાંડવ\N_NN અથવા\CC_CCD લાસ્ય\N_NN નૃત્ય\N_NN અવસ્થા\N_NN .\RD_PUNC
GJRED3	સમાધિ\N_NN અવસ્થા\N_NN અર્થાત્\PSP નિર્ગુણ\JJ અવસ્થા\N_NN અને\CC_CCD નૃત્યાવસ્થા\N_NN એટલે\PSP સગુણ\JJ અવસ્થા\N_NN .\RD_PUNC
GJRED4	એકાદી\JJ નિશ્ચિત\JJ ઘટના\N_NN અથવા\CC_CCD વિષય\N_NN અભિવ્યક્ત\JJ કરવા\V_VAUX_VNP માટે\PSP જે\PR_PRL અંગચાલન\N_NN કરવામાં\V_VAUX_VNP આવે\V_VAUX છે\V_VAUX તેને\DM_DMD નટન\N_NN અથવા\CC_CCD નાટ્ય\N_NN એવી\JJ સંજ્ઞા\N_NN છે\V_VAUX .\RD_PUNC
GJRED5	આ\DM_DMD નટન\N_NN જે\PR_PRL કરે\V_VM તે\PR_PRL નટ\N_NN છે\V_VAUX .\RD_PUNC
GJRED6	શિવજી\N_NNP એ\DM_DMD આદ્યનટ\N_NN છે\V_VAUX એવી\JJ શ્રદ્ધા\N_NN હોવાથી\V_VAUX_VNP તેમને\PR_PRP `\RD_PUNC નટરાજનું\N_NNP `\RD_PUNC એ\DM_DMD બિરુદ\N_NN મળ્યું\V_VM છે\V_VAUX .\RD_PUNC
GJRED7	બ્રહ્માંડ\N_NN આ\DM_DMD નટરાજની\N_NNP નૃત્યશાળા\N_NN છે\V_VAUX .\RD_PUNC
GJRED8	તેઓ\PR_PRP જે\PR_PRL રીતે\N_NN નર્તક\N_NN છે\V_VAUX ,\RD_PUNC તે\DM_DMD રીતે\N_NN તેઓ\PR_PRP તેના\DM_DMD સાક્ષી\N_NN પણ\RP_RPD છે\V_VAUX .\RD_PUNC
GJRED9	એવી\JJ નટરાજ\N_NNP કલ્પના\N_NN પાછળની\JJ ભૂમિકા\N_NN છે\V_VAUX .\RD_PUNC
GJRED10	નટરાજનું\N_NNP નૃત્ય\N_NN આ\DM_DMD સૃષ્ટિ\N_NN ,\RD_PUNC સ્થિતિ\N_NN ,\RD_PUNC સંહાર\N_NN ,\RD_PUNC તિરોભાવ\N_NN (\RD_SYM માયાનું\N_NN આવરણ\N_NN )\RD_SYM અને\CC_CCD અનુગ્રહ\N_NN આ\DM_DMD પાંચ\QT_QTC ઈશ્વરી\JJ ક્રિયાઓનું\N_NN દ્યોતક\JJ માનવામાં\V_VAUX_VNP આવે\V_VAUX છે\V_VAUX .\RD_PUNC
GJRED11	શિવજીએ\N_NNP પોતે\PR_PRF પહેલા\N_NST કરેલું\V_VAUX_VNP ઉદ્વત\JJ નૃત્યનું\N_NN સ્મરણ\N_NN કરીને\V_VAUX_VNP તે\DM_DMD પોતાના\PR_PRF ગણોમાંના\N_NN અગ્રણી\JJ રહેલા\V_VAUX_VNP તંડૂ\N_NNP દ્વારા\PSP ભરતમુનિને\N_NNP બતાવ્યું\V_VM .\RD_PUNC
GJRED12	લાસ્ય:\N_NN આ\DM_DMD સ્ત્રી\N_NN નૃત્ય\N_NN છે\V_VAUX અને\CC_CCD તેમાં\DM_DMD હાથ\N_NN મુક્ત\JJ હોય\V_VAUX છે\V_VAUX .\RD_PUNC
GJRED13	તંડુએ\N_NNP કરી\V_VM બતાવ્યું\V_VM તે\DM_DMD તાંડવ\N_NN ,\RD_PUNC એવું\JJ સમજીને\V_VAUX_VNP ભરત\N_NNP ઈત્યાદિ\N_NN મુનિઓએ\N_NN તે\DM_DMD નૃત્ય\N_NN માનવોને\N_NN શીખવ્યું\V_VM .\RD_PUNC
GJRED14	જે\PR_PRL નૃત્યના\N_NN સમયે\N_NN શરીરમાંના\N_NN ભુવનોનો\N_NN ,\RD_PUNC એટલે\PSP પ્રત્યેક\JJ પેશીનો\N_NN નાદ\N_NN શિવકારક\JJ હોય\V_VAUX છે\V_VAUX ,\RD_PUNC તેને\DM_DMD `\RD_PUNC તાંડવનૃત્ય\N_NN `\RD_PUNC કહે\V_VM છે\V_VAUX .\RD_PUNC
GJRED15	આ\DM_DMD પુરુષ\N_NN નૃત્ય\N_NN હોય\V_VAUX છે\V_VAUX અને\CC_CCD મુદ્રાંકિત\JJ હોય\V_VAUX છે\V_VAUX .\RD_PUNC
GJRED16	આ\DM_DMD નૃત્યના\N_NN સાત\QT_QTC પ્રકાર\N_NN છે\V_VAUX .\RD_PUNC
GJRED17	આ\DM_DMD નૃત્યમાં\N_NN શિવજીનું\N_NNP સ્વરૂપ\N_NN દ્વિભુજ\JJ હોય\V_VAUX છે\V_VAUX .\RD_PUNC
GJRED18	આ\DM_DMD નૃત્યોમાં\N_NN શિવજી\N_NNP ભૈરવ\N_NNP તથા\CC_CCD ગૌરી\N_NNP હોય\V_VAUX છે\V_VAUX .\RD_PUNC
GJRED19	નટરાજના\N_NNP સાત્ત્વિક\JJ નૃત્ય\N_NN પ્રકારોમાં\N_NN સંધ્યાનૃત્ય\N_NN પ્રમાણે\PSP જ\RP_RPD નાદાન્તનૃત્ય\N_NN ઘણું\QT_QTF પ્રસિદ્ધ\JJ છે\V_VAUX .\RD_PUNC
GJRED20	શૈવ\N_NN અને\CC_CCD શાક્ત\N_NN સંપ્રદાયના\N_NN લોકો\N_NN આ\DM_DMD નૃત્યોને\N_NN વિશિષ્ટ\JJ તત્વોના\N_NN પ્રતીક\N_NN માને\V_VM છે\V_VAUX .\RD_PUNC
GJRED21	તેમની\PR_PRP ધારણા\N_NN અનુસાર\PSP આવા\JJ સંહારક\JJ ઉગ્ર\JJ નૃત્યના\N_NN સમયે\N_NN શિવજી\N_NNP કેવળ\PSP જગતનો\N_NN પ્રલય\N_NN કરાવીને\V_VAUX_VNP થોભતા\V_VAUX_VNP નથી\RP_NEG ,\RD_PUNC જ્યારે\N_NST તેઓ\PR_PRP જીવોના\N_NN બંધ\JJ પણ\RP_RPD નષ્ટ\JJ કરે\V_VM છે\V_VAUX .\RD_PUNC
GJRED22	જ્યાં\N_NST જીવોનો\N_NN અહંકાર\N_NN ભસ્મસાત\JJ થઈ\V_VM જાય\V_VAUX છે\V_VAUX ,\RD_PUNC એવી\JJ અવસ્થાનું\N_NN પ્રતીક\N_NN એટલે\PSP સ્મશાનભૂમિ\N_NN છે\V_VAUX .\RD_PUNC
GJRED23	જીવનનું\N_NN સાતત્ય\N_NN સૂચવી\V_VM પંચવિષયોને\N_NN શિવત્વ\N_NN તરફ\PSP પ્રેરતું\V_VAUX_VNP પર્વ\N_NN મહાશિવરાત્રી\N_NNP .\RD_PUNC
GJRED24	આપણા\PR_PRP જીવનો\N_NN શિવ\N_NNP સાથેનો\PSP નાતો\N_NN અતૂટ\JJ છે\V_VAUX .\RD_PUNC
GJRED25	મહાશિવરાત્રી\N_NNP પર્વ\N_NN જીવ\N_NN શિવના\N_NNP અતૂટ\JJ આધ્યાત્મિક\JJ ચૈતસિક\JJ સંબંધને\N_NN અતિ\JJ દ્રઢ\JJ બનાવે\V_VM છે\V_VAUX .\RD_PUNC
GJRED26	મહાવદ\N_NN -\RD_PUNC ૧૪ના\QT_QTC શુભ\JJ દિને\N_NN આ\DM_DMD મહાપર્વ\N_NN મહાશિવરાત્રી\N_NNP દેશ\N_NN અને\CC_CCD દુનિયામાં\N_NN ધામધૂમથી\RB ઉજવાય\V_VM છે\V_VAUX .\RD_PUNC
GJRED27	ઉપાસકોને\N_NN વરદાન\N_NN આપવામાં\V_VAUX_VNP અતિ\JJ ઉદારતા\N_NN દાખવે\V_VM છે\V_VAUX .\RD_PUNC
GJRED28	અશ્વત્થામાને\N_NNP દિવ્ય\JJ ખડગ\N_NN ,\RD_PUNC રાવણને\N_NNP લંકાનું\N_NNP રાજ્ય\N_NN ,\RD_PUNC અર્જુનને\N_NNP પાશુપત્રાસ્ત્રની\N_NNP પ્રાપ્તિ\N_NN શિવજી\N_NNP પાસેથી\PSP જ\RP_RPD થવા\V_VAUX_VNP પામી\V_VM .\RD_PUNC
GJRED29	મહાભારતમાં\N_NNP શિવજીનું\N_NNP કલ્યાણકારી\JJ રૂપ\N_NN દ્રોણપર્વમાં\N_NNP વર્ણવવામાં\V_VAUX_VNP આવ્યું\V_VAUX છે\V_VAUX .\RD_PUNC
GJRED30	અલ્પ\JJ ભક્તિથી\N_NN પ્રસન્ન\JJ થતા\V_VAUX_VNP દેવ\N_NN છે\V_VAUX તેથી\PSP તેઓ\PR_PRP ભોળાનાથ\N_NNP કહેવાય\V_VM છે\V_VAUX .\RD_PUNC
GJRED31	કલ્યાણને\N_NN પામવાનું\V_VAUX_VNP ઉત્તમ\JJ શિખર\N_NN શિવ\N_NNP કહેવાય\V_VM છે\V_VAUX .\RD_PUNC
GJRED32	શિવ\N_NNP ત્રિલોચન\N_NN છે\V_VAUX .\RD_PUNC
GJRED33	કોઈ\DM_DMI પણ\RP_RPD પ્રકારની\N_NN વાસના\N_NN નિર્મૂળ\JJ થયા\V_VM બાદ\PSP ,\RD_PUNC આસક્તિઓ\N_NN ,\RD_PUNC અભિલાષાઓનો\N_NN નાશ\N_NN થયા\V_VM બાદ\PSP શિવજીનો\N_NNP સાક્ષાત્કાર\N_NN શક્ય\JJ બને\V_VM છે\V_VAUX .\RD_PUNC
GJRED34	પૂર્ણયોગ\N_NN તથા\CC_CCD સિદ્ધ\JJ યૌગિક\JJ દશા\N_NN પ્રાપ્ત\JJ થાય\V_VM છે\V_VAUX .\RD_PUNC
GJRED35	સર્પો\N_NN તો\RP_RPD વિષયોના\N_NN પ્રતીક\N_NN છે\V_VAUX .\RD_PUNC
GJRED36	જેમ\PSP વિષવાળા\JJ દાંત\N_NN પાડી\V_VM નાખેલા\V_VAUX_VNP સર્પ\N_NN નુકશાનકારક\JJ નથી\RP_NEG તેમ\PSP નિર્વિષ\JJ વિષયો\N_NN પણ\RP_RPD હાનિકારક\JJ નથી\RP_NEG .\RD_PUNC
GJRED37	શિવજીના\N_NNP મસ્તકમાંથી\N_NN નિરંતર\JJ જ્ઞાનગંગા\N_NN વહેતી\V_VAUX_VNP જ\RP_RPD રહે\V_VM છે\V_VAUX .\RD_PUNC
GJRED38	શિવજીના\N_NNP હાથનું\N_NN ડમરુ\N_NN એ\DM_DMD સંગીતનું\N_NN સૂરનું\N_NN પ્રતીક\N_NN છે\V_VAUX .\RD_PUNC
GJRED39	એમ\PSP કહેવાય\V_VM છે\V_VAUX કે\CC_CCS અમૃત\N_NN પીયે\V_VM તે\DM_DMD દેવ\N_NN કિન્તુ\N_NN ઝેર\N_NN પીને\V_VAUX_VNP પચાવે\V_VM તે\DM_DMD મહાદેવ\N_NNP .\RD_PUNC
GJRED40	અન્યોના\JJ ગુણને\N_NN મસ્તક\N_NN પર\PSP ચંદ્ર\N_NN દ્વારા\PSP ધારણ\V_VM કરે\V_VM છે\V_VAUX .\RD_PUNC
GJRED41	વાયુ\N_NNP પુરાણમાં\N_NNP શિવજી\N_NNP પ્રત્યે\PSP વિષ્ણુ\N_NNP તથા\CC_CCD બ્રહ્માની\N_NNP સ્તુતિ\N_NN દર્શાવી\V_VM છે\V_VAUX .\RD_PUNC
GJRED42	અમારા\PR_PRP સર્વ\JJ માટે\PSP કલ્યાણકારી\JJ છો\V_VAUX .\RD_PUNC
GJRED43	વિશ્વના\N_NN આદિકારણ\N_NN છો\V_VAUX .\RD_PUNC
GJRED44	વેદ\N_NNP પણ\RP_RPD આપને\PR_PRP નેતિ\N_NN નેતિ\N_NN કહે\V_VM છે\V_VAUX .\RD_PUNC
GJRED45	સૌરપુરાણ\N_NNP અનુસાર\PSP જેઓ\PR_PRL બિલ્વવૃક્ષ\N_NN હેઠળ\PSP શિવનામ\N_NNP જપે\V_VM છે\V_VAUX તેઓ\PR_PRP માનવ\N_NN મનથી\N_NN કરેલા\V_VAUX_VNP દોષો\N_NN તથા\CC_CCD પાપોથી\N_NN છુટકારો\N_NN પામે\V_VM છે\V_VAUX .\RD_PUNC
GJRED46	શિવજીને\N_NNP `\RD_PUNC રૂદ્ર\N_NN `\RD_PUNC પણ\RP_RPD કહે\V_VM છે\V_VAUX .\RD_PUNC
GJRED47	સમસ્ત\JJ પ્રાણીઓના\N_NN વિશ્રામ\N_NN સ્થાન\N_NN તરીકે\PSP શિવજીને\N_NNP ઓળખવામાં\V_VAUX_VNP આવી\V_VM રહ્યા\V_VAUX છે\V_VAUX .\RD_PUNC
GJRED48	ગીતાજીના\N_NNP ૧૩મા\QT_QTO અધ્યાયનો\N_NN ૫૧મો\QT_QTO શ્લોક\N_NN શિવતત્ત્વને\N_NNP પરમ\JJ તત્ત્વ\N_NN તરીકે\PSP ઓળખાવે\V_VM છે\V_VAUX .\RD_PUNC
GJRED49	કોઈ\DM_DMI પણ\RP_RPD શિવ\N_NNP મંદિરમાં\N_NNP કાચબો\N_NN તથા\CC_CCD પોઠિયો\N_NN દ્રશ્યમાન\JJ થાય\V_VM છે\V_VAUX .\RD_PUNC
GJRED50	કાચબો\N_NN એ\DM_DMD સંયમનું\N_NN પ્રતીક\N_NN છે\V_VAUX .\RD_PUNC
GJRED51	સંયમથી\N_NN જ\RP_RPD પંચવિષય\N_NN પર\PSP કાબુ\N_NN રાખી\V_VM સાક્ષાત્કાર\N_NN કરી\V_VM શકે\V_VAUX છે\V_VAUX .\RD_PUNC
GJRED52	લોકવાણી\N_NN એવી\JJ છે\V_VAUX કે\CC_CCS `\RD_PUNC પ્રભુનો\N_NN બન્યો\V_VM તે\DM_DMD પોઠિયો\N_NN .\RD_PUNC `\RD_PUNC
GJRED53	શિવરાત્રી\N_NN પર્વમાં\N_NN શિવ\N_NNP ઉપાસનાનું\N_NN અનેરું\JJ મહાત્મ્ય\N_NN છે\V_VAUX .\RD_PUNC
GJRED54	સ્કંદપુરાણમાં\N_NNP ઉપદેશ્યું\V_VM છે\V_VAUX કે\CC_CCS શિવલિંગ\N_NNP ઉપાસના\N_NN કરવાથી\V_VAUX_VNP ઈન્દ્ર\N_NN ,\RD_PUNC વરુણ\N_NN ,\RD_PUNC કુબેર\N_NN ,\RD_PUNC સૂર્ય\N_NN ,\RD_PUNC ચંદ્ર\N_NNP વગેરેમાંથી\PSP કોઈ\PR_PRI સ્વર્ગાધિપતિ\N_NN બન્યા\V_VM ,\RD_PUNC કોઈ\PR_PRI રાજાની\N_NN પદવીને\N_NN પામ્યા\V_VM .\RD_PUNC
GJRED55	કોઈ\PR_PRI દિકપાલ\N_NN ,\RD_PUNC લોકપાલ\N_NN ,\RD_PUNC પ્રજાપતિ\N_NN તથા\CC_CCD પૃથ્વી\N_NN પર\PSP ચક્રવર્તી\N_NN મહારાજાઓના\N_NN પદની\N_NN પ્રાપ્તિને\N_NN વર્યા\V_VM .\RD_PUNC
GJRED56	શિવમહાપુરાણમાં\N_NNP ઉલ્લેખ\N_NN છે\V_VAUX કે\CC_CCS લિંગની\N_NN પૂજા\N_NN કરવાથી\V_VAUX_VNP શિવ\N_NNP -\RD_PUNC પાર્વતી\N_NNP બન્નેની\JJ પૂજા\N_NN થાય\V_VM છે\V_VAUX .\RD_PUNC
GJRED57	જુદી\JJ પૂજા\N_NN કરવાની\V_VAUX_VNP રહેતી\V_VAUX_VNP નથી\RP_NEG .\RD_PUNC
GJRED58	આથી\PSP શિવ\N_NNP એકના\QT_QTC પૂજનમાં\N_NN શિવ\N_NNP -\RD_PUNC પાર્વતી\N_NNP આદિ\PSP તથા\CC_CCD બ્રહ્મા\N_NNP -\RD_PUNC વિષ્ણુનું\N_NNP પૂજન\N_NN સમાવિષ્ટ\JJ થઈ\V_VM જાય\V_VAUX છે\V_VAUX .\RD_PUNC
GJRED59	શિવજી\N_NNP યોગીઓમાં\N_NN શ્રેષ્ઠ\JJ એટલે\PSP યોગેશ્વર\N_NNP ,\RD_PUNC તત્ત્વજ્ઞાન\N_NN તથા\CC_CCD વૈરાગ્યમાં\N_NN અતિ\JJ ઉત્તમ\JJ જ્ઞાન\N_NN સભર\JJ દયાળુ\JJ દેવ\N_NN એટલે\PSP મહાદેવ\N_NNP કહેવાય\V_VM છે\V_VAUX .\RD_PUNC
GJRED60	પુત્ર\N_NN નથી\RP_NEG ,\RD_PUNC ધન\N_NN નથી\RP_NEG ,\RD_PUNC સ્વાસ્થ્ય\N_NN નથીનાં\RP_NEG રોદણાં\N_NN રડતાં\V_VAUX_VNP ઘણા\QT_QTF લોકો\N_NN જોવા\V_VAUX_VNP મળે\V_VM છે\V_VAUX .\RD_PUNC
GJRED61	પરંતુ\CC_CCD ભાગ્યે\PSP જ\RP_RPD એવા\JJ વિરલા\N_NN રડતાં\V_VAUX_VNP જોવા\V_VAUX_VNP મળશે\V_VM .\RD_PUNC
GJRED62	રોદણું\N_NN રડતા\V_VAUX_VNP હોય\V_VAUX કે\CC_CCS પ્રકાશ\N_NN નથી\RP_NEG ,\RD_PUNC ભગવાન\N_NN નથી\RP_NEG ,\RD_PUNC સત્કર્મ\N_NN નથી\RP_NEG .\RD_PUNC
GJRED63	જો\CC_CCD આના\DM_DMD માટે\PSP લોકો\N_NN રડવા\V_VAUX_VNP લાગે\V_VM તો\CC_CCD એમને\PR_PRP કોઈ\DM_DMI જ\RP_RPD વાતની\N_NN કમી\N_NN ન\RP_NEG રહે\V_VAUX .\RD_PUNC
GJRED64	જે\PR_PRL સંસાર\N_NN ત્યાગી\JJ છે\V_VAUX એ\PR_PRL તો\RP_RPD ઈશ્વરને\N_NN યાદ\N_NN કરે\V_VM જ\RP_RPD ,\RD_PUNC તેમાં\DM_DMD વળી\PSP બહાદુરી\N_NN શી\PR_PRQ ?\RD_PUNC
GJRED65	પરંતુ\CC_CCD સંસારમાં\N_NN રહેવા\V_VAUX_VNP છતાં\RP_RPD ઈશ્વરનું\N_NN સ્મરણ\N_NN કરે\V_VM એ\DM_DMD જ\RP_RPD ધન્ય\JJ .\RD_PUNC
GJRED66	તોફાની\JJ ઘોડો\N_NN આંખે\N_NN અંધારી\N_NN બાંધી\N_NN ન\RP_NEG હોય\V_VAUX તો\CC_CCD સીધો\JJ ચાલતો\V_VAUX_VNP નથી\RP_NEG .\RD_PUNC
GJRED67	તેમ\PSP વિવેક\N_NN -\RD_PUNC વૈરાગ્યરૂપી\JJ અંધારી\N_NN સંસારી\JJ જીવના\N_NN મન\N_NN પર\PSP બંધાતી\V_VAUX_VNP નથી\RP_NEG ત્યાં\N_NST સુધી\PSP કુમાર્ગે\N_NN જતા\V_VAUX_VNP તેના\PR_PRP મનને\N_NN પણ\RP_RPD અટકાવી\V_VM શકાતું\V_VAUX_VNP નથી\RP_NEG .\RD_PUNC
GJRED68	વહાણ\N_NN પાણીમાં\N_NN રહે\V_VM તો\CC_CCD કોઈ\DM_DMI વાંધો\N_NN નથી\RP_NEG પણ\CC_CCD પાણી\N_NN વહાણમાં\N_NN ન\RP_NEG રહેવું\V_VAUX_VNP જોઈએ\V_VAUX .\RD_PUNC
GJRED69	એ\DM_DMD જ\RP_RPD રીતે\N_NN સાધક\N_NN ભલે\PSP સંસારમાં\N_NN રહે\V_VM પણ\CC_CCD તેનું\DM_DMD મન\N_NN સંસારમાં\N_NN ન\RP_NEG રહેવું\V_VAUX_VNP જોઈએ\V_VAUX .\RD_PUNC
GJRED70	ચુંબક\N_NN પથ્થર\N_NN પાણીમાં\N_NN પડેલો\V_VAUX_VNP રહે\V_VAUX તો\CC_CCD પણ\RP_RPD લોખંડને\N_NN આકર્ષવાનો\V_VAUX_VNP અને\CC_CCD ઘસતાં\V_VAUX_VNP જ\RP_RPD આગ\N_NN પેદા\JJ કરવાનો\V_VAUX_VNP એનો\DM_DMD ગુણ\N_NN ખલાસ\JJ થઈ\V_VM જતો\V_VAUX_VNP નથી\RP_NEG .\RD_PUNC
GJRED71	વિષમ\JJ પરિસ્થિતિમાં\N_NN ઘેરાયેલા\V_VAUX_VNP રહેવા\V_VAUX_VNP છતાં\RP_RPD સજ્જનો\N_NN પોતાના\PR_PRF આદર્શો\N_NN છોડતા\V_VAUX_VNP નથી\RP_NEG .\RD_PUNC
GJRED72	દોરામાં\N_NN ગાંઠ\N_NN પડેલી\V_VAUX_VNP હોય\V_VAUX તો\CC_CCD તે\DM_DMD સોયના\N_NN નાકામાં\N_NN ઘૂસી\V_VM શકતો\V_VAUX_VNP નથી\RP_NEG .\RD_PUNC
GJRED73	અને\CC_CCD તેનાથી\DM_DMD સિવાતું\V_VAUX_VNP નથી\RP_NEG .\RD_PUNC
GJRED74	મનમાં\N_NN જો\CC_CCD સ્વાર્થસભર\JJ સંકીર્ણતાની\N_NN ગાંઠ\N_NN પડેલી\V_VAUX_VNP હોય\V_VAUX તો\CC_CCD તે\DM_DMD ઈશ્વરમાં\N_NN લાગી\V_VM શકાતું\V_VAUX_VNP નથી\RP_NEG અને\CC_CCD જીવનનું\N_NN લક્ષ્ય\N_NN પ્રાપ્ત\JJ કરી\V_VM શકતું\V_VAUX_VNP નથી\RP_NEG .\RD_PUNC
GJRED75	એકલું\JJ ભણ્યે\V_VAUX_VNP શું\PR_PRQ વળે\V_VM ?\RD_PUNC
GJRED76	ધારણા\N_NN ક્યાં\N_NST ?\RD_PUNC
GJRED77	પંચાગમાં\N_NNP લખ્યું\V_VM છે\V_VAUX કે\CC_CCS વીસ\QT_QTC ઈંચ\N_NN પાણી\N_NN પડશે\V_VM .\RD_PUNC
GJRED78	પરંતુ\CC_CCD પંચાગ\N_NNP નિચોવો\V_VM તો\CC_CCD એક\QT_QTC ટીપું\N_NN ન\RP_NEG પડે\V_VM .\RD_PUNC
GJRED79	આપણી\PR_PRP ભારતીય\JJ સંસ્કૃતિ\N_NN અને\CC_CCD હિંદુ\N_NNP ધર્મ\N_NNP અધ્યાત્મનો\N_NN અમર\JJ વારસો\N_NN છે\V_VAUX .\RD_PUNC
GJRED80	આ\DM_DMD બધાં\QT_QTF સંવર્ગના\N_NN માનવીઓ\N_NN પ્રત્યક્ષ\JJ -\RD_PUNC પરોક્ષ\JJ રીતે\N_NN જન્મ\N_NN અથવા\CC_CCD કર્મથી\N_NN મહાપ્રભુ\N_NN શ્રી\N_NN વિશ્વકર્માના\N_NNP વંશ\N_NN જ\RP_RPD ગણાય\V_VM છે\V_VAUX .\RD_PUNC
GJRED81	દેવોના\N_NN શિલ્પી\N_NN અને\CC_CCD વાસ્તુ\N_NN વિશારદ\N_NN તરીકે\PSP બધાં\QT_QTF ધર્મશાસ્ત્રોમાં\N_NN શ્રી\N_NN વિશ્વકર્મા\N_NNP પ્રભુનો\N_NNP ઉલ્લેખ\N_NN જોવા\V_VAUX_VNP મળે\V_VM છે\V_VAUX .\RD_PUNC
GJRED82	શાસ્ત્રવિદોએ\N_NN શિલ્પકલાને\N_NN વેદવિદ્યાની\N_NNP બહેન\N_NN ગણેલી\V_VAUX_VNP છે\V_VAUX .\RD_PUNC
GJRED83	તેથી\PSP શિલ્પ\N_NN શાસ્ત્રની\N_NN ગણના\N_NN વેદમાં\N_NNP કરવામાં\V_VAUX_VNP આવે\V_VAUX છે\V_VAUX .\RD_PUNC
GJRED84	તેથી\PSP જ\RP_RPD આગામી\JJ મહા\N_NN સુદ\N_NN :\RD_PUNC ૧૩\QT_QTC શનિવાર\N_NN તા.\N_NN ૨૩-૨-૨૦૧૩ના\N_NNP સમગ્ર\JJ કારીગર\N_NN વર્ગ\N_NN શ્રી\N_NN વિશ્વકર્મા\N_NNP પ્રભુની\N_NNP જયંતી\N_NN દિન\N_NN તરીકે\PSP તેમનું\DM_DMD ષોડષોપચારે\N_NN પૂજન\N_NN અર્ચન\N_NN કરશે\V_VM .\RD_PUNC
GJRED85	ઉત્સવ\N_NN તરીકે\PSP ઉજવણી\N_NN કરી\V_VM સમૂહ\N_NN મહાપ્રસાદ\N_NN ગ્રહણ\N_NN કરશે\V_VM .\RD_PUNC
GJRED86	વિશ્વ\N_NN એટલે\PSP જગત\N_NN અને\CC_CCD કર\N_NN એટલે\PSP હાથ\N_NN .\RD_PUNC
GJRED87	જેના\PR_PRL હાથ\N_NN વડે\PSP આ\DM_DMD જગતનું\N_NN સર્જન\N_NN થયું\V_VM છે\V_VAUX ,\RD_PUNC તે\PR_PRL દેવ\N_NN એટલે\PSP વિશ્વકર્મા\N_NNP .\RD_PUNC
GJRED88	જેમના\PR_PRL હાથમાં\N_NN પૃથ્વી\N_NNP છે\V_VAUX .\RD_PUNC
GJRED89	જેમનું\PR_PRL શરીર\N_NN વૃદ્ધાવસ્થા\N_NN દર્શાવે\V_VM છે\V_VAUX .\RD_PUNC
GJRED90	જેમના\PR_PRL મસ્તક\N_NN ઉપર\PSP મુગટ\N_NN જોવા\V_VAUX_VNP મળે\V_VM છે\V_VAUX .\RD_PUNC
GJRED91	જેમના\PR_PRL એક\QT_QTC હાથમાં\N_NN કામી\N_NN એટલે\PSP ગજ\N_NN .\RD_PUNC
GJRED92	બીજા\QT_QTO હાથમાં\N_NN ત્રાંબાનું\N_NN કમંડળ\N_NN ,\RD_PUNC ત્રીજા\QT_QTO હાથમાં\N_NN જ્ઞાન\N_NN +\RD_SYM ગ્રંથ\N_NN ,\RD_PUNC ચોથા\QT_QTO હાથમાં\N_NN માળાના\N_NN દર્શન\N_NN થાય\V_VM છે\V_VAUX .\RD_PUNC
GJRED93	હંસ\N_NN જેમનું\PR_PRL વાહન\N_NN છે\V_VAUX .\RD_PUNC
GJRED94	જેમને\PR_PRL ત્રણ\QT_QTC નેત્રો\N_NN છે\V_VAUX .\RD_PUNC
GJRED95	એવી\JJ મૂર્તિ\N_NN તે\DM_DMD જ\RP_RPD શ્રી\N_NN વિશ્વકર્મા\N_NNP પ્રભુ\N_NNP .\RD_PUNC
GJRED96	આ\DM_DMD બધું\QT_QTF જ\RP_RPD દેવાધિદેવ\N_NN શ્રી\N_NN વિશ્વકર્મા\N_NNP પ્રભુની\N_NN જ\RP_RPD દેન\N_NN છે\V_VAUX .\RD_PUNC
GJRED97	નોંધપાત્ર\JJ બાબત\N_NN એ\DM_DMD છે\V_VAUX કે\CC_CCS અન્ય\JJ દેવી\N_NN -\RD_PUNC દેવતાઓએ\N_NN ઘણાનો\QT_QTF વધ\N_NN કર્યો\V_VM છે\V_VAUX .\RD_PUNC
GJRED98	બ્રહ્મ\N_NNP વિશ્વકર્માના\N_NNP નામે\N_NN વિશ્વકર્માના\N_NNP દશ\QT_QTC અવતારોનો\N_NN ઉલ્લેખ\N_NN શાસ્ત્રમાં\N_NN વર્ણવેલો\V_VAUX_VNP છે\V_VAUX .\RD_PUNC
GJRED99	વિશ્વકર્માએ\N_NNP પ્રથમ\QT_QTO ઓજાર\N_NN ``\RD_PUNC ગજ\N_NN ``\RD_PUNC પોતાના\PR_PRF પુત્રોને\N_NN આપ્યું\V_VM હતું\V_VAUX .\RD_PUNC
GJRED100	જેમા\PR_PRL ચોવીસ\QT_QTC ઈંચ\N_NN હોય\V_VAUX છે\V_VAUX .\RD_PUNC
GJRED101	ઈંચની\N_NN પ્રત્યેક\JJ રેખાઓ\N_NN ઉપર\PSP દેવતાઓનો\N_NN વાસ\N_NN છે\V_VAUX .\RD_PUNC
GJRED102	નવમી\QT_QTO રેખા\N_NN પર\PSP વિશ્વકર્માનો\N_NNP વાસ\N_NN છે\V_VAUX .\RD_PUNC
GJRED103	મહારાષ્ટ્રમાં\N_NNP ઔરંગાબાદ\N_NNP પાસે\PSP વેસળ\N_NNP ગામની\N_NN નજીક\JJ વિશ્વવિખ્યાત\JJ `\RD_PUNC ઈલોરાની\N_NNP `\RD_PUNC ગુફાઓ\N_NN છે\V_VAUX .\RD_PUNC
GJRED104	તેમાં\DM_DMD દસ\QT_QTC નંબરની\N_NN ગુફામાં\N_NN વિશ્વકર્માની\N_NNP મૂર્તિ\N_NN છે\V_VAUX .\RD_PUNC
GJRED105	તેની\DM_DMD મુલાકાતયાત્રા\N_NN કારીગરો\N_NN કરતાં\V_VAUX_VNP હોય\V_VAUX છે\V_VAUX .\RD_PUNC
GJRED106	તમામ\JJ પ્રકારની\N_NN કલાઓ\N_NN ધાતુઓના\N_NN સાધનો\N_NN ,\RD_PUNC પાત્રો\N_NN ,\RD_PUNC પંચતત્ત્વથી\N_NN ચાલતા\V_VAUX_VNP યંત્રો\N_NN ,\RD_PUNC જળ\N_NN ,\RD_PUNC ઔષધિઓ\N_NN ,\RD_PUNC સ્થળ\N_NN -\RD_PUNC આકાશમાં\N_NN ચાલતા\V_VAUX_VNP વાહનો\N_NN વગેરેના\PSP શિલ્પ\N_NN સ્થાપત્યના\N_NN નિર્માણ\N_NN કાર્યમાં\N_NN તમે\PR_PRP એક\QT_QTC બીજા\JJ બ્રહ્મા\N_NNP બનશો\V_VM .\RD_PUNC
GJRED107	વિશ્વકર્માની\N_NNP એકસો\QT_QTC આઠ\QT_QTC નામની\N_NN નામાવલિનો\N_NN ભાવિકો\N_NN જાપ\N_NN કરે\V_VM છે\V_VAUX .\RD_PUNC
GJRED108	વિશ્વકર્માના\N_NNP નામમાં\N_NN `\RD_PUNC મા\N_NN `\RD_PUNC અક્ષર\N_NN છે\V_VAUX કારણકે\CC_CCS તેમણે\PR_PRP પોતાના\PR_PRF પાંચે\QT_QTC ય\RP_RPD પુત્રોને\N_NN મા\N_NN અને\CC_CCD બાપ\N_NN બંનેનો\JJ સ્નેહ\N_NN આપ્યો\V_VM હતો\V_VAUX .\RD_PUNC
GJRED109	વિશ્વકર્માએ\N_NNP પોતાના\PR_PRF પુત્રોને\N_NN ``\RD_PUNC આલોચ\N_NNP વિદ્યા\N_NNP ``\RD_PUNC આપી\V_VM હતી\V_VAUX .\RD_PUNC
GJRED110	પણ\CC_CCD તેનો\PR_PRP દુરઉપયોગ\N_NN થતાં\V_VAUX_VNP તે\DM_DMD પાછી\RB ખેંચી\V_VM લીધી\V_VAUX_VNP હતી\V_VAUX .\RD_PUNC
GJRED111	વિશ્વકર્મા\N_NNP પોતે\PR_PRF શિવરૂપ\N_NN હોવાથી\V_VAUX_VNP તેમના\PR_PRP વંશજો\N_NN પણ\RP_RPD શિવરૂપ\N_NNP ગણાય\V_VM છે\V_VAUX .\RD_PUNC
GJRED112	તે\DM_DMD બધાએ\QT_QTF ત્રિકાળ\JJ સંધ્યા\N_NN ,\RD_PUNC ગાયત્રી\N_NNP પૂજન\N_NN ,\RD_PUNC વેદાભ્યાસ\N_NNP અને\CC_CCD ઓમનું\N_NNP ધ્યાન\N_NN કરવું\V_VAUX_VNP જોઈએ\V_VAUX .\RD_PUNC
GJRED113	શ્રી\N_NN વિશ્વકર્મા\N_NNP ચરિત્રને\N_NN આલેખતો\V_VAUX_VNP ગ્રંથ\N_NN ``\RD_PUNC શ્રી\N_NNP વિશ્વકર્મા\N_NNP પુરાણ\N_NNP ``\RD_PUNC બજારમાં\N_NN ઉપલબ્ધ\JJ છે\V_VAUX .\RD_PUNC
GJRED114	ભારતીય\JJ જીવન\N_NN સંસ્કૃતિમાં\N_NN વારંવાર\PSP તહેવારો\N_NN આવતા\V_VAUX_VNP હોય\V_VAUX છે\V_VAUX .\RD_PUNC
GJRED115	તેનો\DM_DMD આનંદ\N_NN અવિસ્મરણીય\JJ હોય\V_VAUX છે\V_VAUX .\RD_PUNC
GJRED116	દરેક\JJ તહેવારો\N_NN જીવનમાં\N_NN નવું\JJ જોમ\N_NN થનગનાટ\N_NN પ્રગટ\JJ કરે\V_VM છે\V_VAUX .\RD_PUNC
GJRED117	ભારતીય\JJ દરેક\JJ તહેવારોમાં\N_NN વિશ્વકર્મા\N_NNP જયંતીનું\N_NN અનોખું\JJ મહત્ત્વ\N_NN છે\V_VAUX .\RD_PUNC
GJRED118	વિશ્વકર્મા\N_NNP વંશના\N_NNP લોકો\N_NN દેશમાં\N_NN વિશ્વકર્માનું\N_NNP પૂજન\N_NN કરે\V_VM છે\V_VAUX .\RD_PUNC
GJRED119	બધા\QT_QTF સાથે\PSP મળી\V_VM શહેરમાં\N_NN શોભાયાત્રા\N_NN કાઢે\V_VM છે\V_VAUX .\RD_PUNC
GJRED120	મહાપ્રસાદ\N_NN સાથે\PSP મળી\V_VM શિલ્પકારો\N_NN રથકારો\N_NN લે\V_VM છે\V_VAUX .\RD_PUNC
GJRED121	તે\DM_DMD દિવસે\PSP વિશ્વકર્માપ્રભુની\N_NNP શોભાયાત્રા\N_NN કાઢતો\V_VAUX_VNP કારીગર\N_NN વર્ગ\N_NN હોય\V_VAUX છે\V_VAUX .\RD_PUNC
GJRED122	તેની\DM_DMD ઝાંખીની\N_NN શોભા\N_NN અતિ\JJ સુંદર\JJ હોય\V_VAUX છે\V_VAUX .\RD_PUNC
GJRED123	કારણકે\CC_CCS કલા\N_NN કૌશલ્યના\N_NN જાણકાર\N_NN વર્ગના\N_NN વિરાટ\JJ વિશ્વકર્મા\N_NNP ઈષ્ટદેવ\N_NN અને\CC_CCD ગુરુ\N_NN છે\V_VAUX .\RD_PUNC
GJRED124	આ\DM_DMD દિવસે\N_NN સમસ્ત\JJ ભારતના\N_NNP લોકોને\N_NN એક\QT_QTC મહાન\JJ વિજ્ઞાનના\N_NN પરમ\JJ પિતામહ\N_NN મળ્યા\V_VM છે\V_VAUX ,\RD_PUNC
GJRED125	તેથી\PSP વિશ્વકર્મા\N_NNP વંશજો\N_NN મહાસુદ\N_NN ૧૩ની\QT_QTC વિશ્વકર્મા\N_NNP જયંતી\N_NNP અરસપરસ\PR_PRC આનંદની\N_NN વહેંચણી\N_NN કરી\V_VAUX_VNP ઊજવીએ\V_VM છીએ\V_VAUX .\RD_PUNC
GJRED126	સાથે\PSP સાથે\PSP મહા\JJ સુખનો\N_NN આનંદ\N_NN લૂંટીએ\V_VM છીએ\V_VAUX .\RD_PUNC
GJRED127	વિરાટ\JJ વિશ્વકર્માનું\N_NNP આ\DM_DMD શુભ\JJ દિવસે\N_NST દેવલોકમાંથી\N_NNP પૃથ્વીલોકમાં\N_NNP આવાગમન\N_NN થયું\V_VM છે\V_VAUX .\RD_PUNC
GJRED128	તે\DM_DMD દિવસથી\N_NST અંધકારમય\JJ જગતમાં\N_NN પ્રકાશ\N_NN ફેલાઈ\V_VM ગયો\V_VAUX .\RD_PUNC
GJRED129	જગત\N_NN પ્રકાશમય\JJ થયું\V_VM .\RD_PUNC
GJRED130	વિશ્વકર્માને\N_NNP પૃથ્વી\N_NNP પર\PSP ઉતારનાર\V_VAUX_VNP પૃથ્થુ\N_NNP રાજા\N_NNP છે\V_VAUX .\RD_PUNC
GJRED131	પૃથ્થુ\N_NNP રાજા\N_NNP પર\PSP વિરાટ\JJ વિશ્વકર્માની\N_NNP કૃપા\N_NN ઉતરવાથી\V_VAUX_VNP પૃથ્થુએ\N_NNP પૃથ્વીને\N_NNP ગાય\N_NN બનાવી\V_VM દોહન\N_NN કર્યું\V_VM .\RD_PUNC
GJRED132	પૃથ્વીમાંથી\N_NNP વિશ્વકર્માની\N_NNP કૃપા\N_NN થવાથી\V_VAUX_VNP વિજ્ઞાનરૂપી\JJ ગાયનું\N_NN દોહન\N_NN કરવાથી\V_VAUX_VNP પૃથ્વી\N_NNP પર\PSP જે\PR_PRL જે\PR_PRL વસ્તુઓ\N_NN દેખાય\V_VM છે\V_VAUX તે\PR_PRL સર્વ\N_NN પૃથ્વીએ\N_NNP આપ્યું\V_VM છે\V_VAUX .\RD_PUNC
GJRED133	વિશ્વકર્માએ\N_NNP પૃથ્વીને\N_NNP જ્ઞાન\N_NN અને\CC_CCD વિજ્ઞાન\N_NN બન્ને\JJ આપ્યાં\V_VM છે\V_VAUX .\RD_PUNC
GJRED134	જેના\PR_PRL કારણે\PSP રાજાથી\N_NN લઈ\V_VM રંક\JJ જનોને\N_NN અન્ન\N_NN ,\RD_PUNC મકાન\N_NN ,\RD_PUNC કપડાં\N_NN લોકોને\N_NN મળ્યાં\V_VM જીવન\N_NN જીવવાનું\V_VAUX_VNP વિજ્ઞાનિક\JJ જ્ઞાન\N_NN પ્રાપ્ત\JJ થયું\V_VM .\RD_PUNC
GJRED135	મનુષ્ય\N_NN વિચારે\V_VM તો\CC_CCD વિશ્વકર્મા\N_NNP જયંતીનો\N_NNP તહેવાર\N_NN સઘળી\JJ માનવ\N_NN જાતિના\N_NN ઉત્થાનનો\N_NN તહેવાર\N_NN છે\V_VAUX .\RD_PUNC
GJRED136	તેથી\PSP સઘળી\JJ માનવ\N_NN જાતે\PR_PRC પોતાનો\PR_PRF ઉત્થાનનો\N_NN દિવસ\N_NN માની\V_VM ઉત્સવ\N_NN મનાવવો\V_VAUX_VNP જોઈએ\V_VAUX .\RD_PUNC
GJRED137	સનાતન\N_NNP ધર્મરૂપ\N_NN છે\V_VAUX ,\RD_PUNC પણ\CC_CCD બીજા\JJ ધર્મોનું\N_NN એટલું\JJ મોટું\JJ આક્રમણ\N_NN થયું\V_VM કે\CC_CCS લોકો\N_NN સનાતન\N_NNP ધર્મ\N_NNP છોડી\V_VAUX_VNP જુદા\JJ -\RD_PUNC જુદા\JJ ધર્મના\N_NN વાડાઓમાં\N_NN રોકાઈ\V_VM ગયા\V_VAUX .\RD_PUNC
GJRED138	તેથી\PSP વિશ્વકર્મા\N_NNP ધર્મના\N_NN અનુયાયીઓ\N_NN પણ\RP_RPD આકર્ષાઈને\V_VAUX_VNP વિશ્વકર્મા\N_NNP સનાતન\N_NNP ધર્મ\N_NNP ભૂલવા\V_VAUX_VNP લાગ્યા\V_VAUX .\RD_PUNC
GJRED139	શ્રીકૃષ્ણએ\N_NNP સ્વધર્મ\N_NN ન\RP_NEG છોડવા\V_VAUX_VNP બહુ\QT_QTF કહ્યું\V_VM છે\V_VAUX ,\RD_PUNC સ્વધર્મમાં\N_NN જ\RP_RPD રહેવું\V_VAUX_VNP તેમ\PSP આગ્રહ\N_NN કર્યો\V_VM છે\V_VAUX .\RD_PUNC
GJRED140	તેના\DM_DMD ગુણ\N_NN ગાયા\V_VM છે\V_VAUX .\RD_PUNC
GJRED141	તેથી\PSP વિશ્વકર્માએ\N_NNP આપેલ\V_VAUX_VNP જ્ઞાન\N_NN વિજ્ઞાન\N_NN ભૂલાવા\V_VAUX_VNP લાગ્યા\V_VM .\RD_PUNC
GJRED142	આથી\PSP સનાતન\N_NNP ધર્મ\N_NNP લોકો\N_NN પાસેથી\PSP દૂર\JJ જવા\V_VAUX_VNP લાગ્યો\V_VAUX .\RD_PUNC
GJRED143	સનાતન\N_NNP ધર્મ\N_NN છોડી\V_VAUX_VNP મનુષ્ય\N_NN સગવડીયો\JJ ધર્મ\N_NN સ્વીકારવા\V_VAUX_VNP લાગ્યા\V_VAUX .\RD_PUNC
GJRED144	લોકો\N_NN સ્વધર્મ\N_NN ભૂલવા\V_VAUX_VNP લાગ્યા\V_VAUX .\RD_PUNC
GJRED145	તે\DM_DMD વિશ્વકર્મા\N_NNP સર્વ\JJ લોકોની\N_NN રચનાના\N_NN કાર્યમાં\N_NN લાગી\V_VM ગયા\V_VAUX છે\V_VAUX .\RD_PUNC
GJRED146	અર્થ\N_NN -\RD_PUNC અવતરી\V_VM વિશ્વકર્માને\N_NNP ચાર\QT_QTC હાથ\N_NN છે\V_VAUX ,\RD_PUNC યક્ષ\N_NN માળા\N_NN પહેરી\V_VM છે\V_VAUX .\RD_PUNC
GJRED147	હંસ\N_NN જેમનું\PR_PRL ન્યાયીશક્તિવાળું\JJ વાહન\N_NN છે\V_VAUX ,\RD_PUNC એવા\JJ વિશ્વકર્મા\N_NNP પ્રભુને\N_NNP અમે\PR_PRP વંદન\N_NN કરીએ\V_VM છીએ\V_VAUX .\RD_PUNC
GJRED148	પુરાણો\N_NNP કહે\V_VM છે\V_VAUX ,\RD_PUNC વિશ્વકર્મા\N_NNP ઋતુઓની\N_NN પ્રાણના\N_NN કરી\V_VAUX_VNP ઋતુઓના\N_NN ગુણ\N_NN ,\RD_PUNC સ્વભાવ\N_NN અને\CC_CCD વાતાવર્ણન\N_NN પ્રમાણે\PSP ઋતુઓના\N_NN મહિનાઓના\N_NN નામ\N_NN પાડ્યા\V_VM છે\V_VAUX .\RD_PUNC
GJRED149	ક્યાં\DM_DMQ ક્યાં\DM_DMQ દેશમાં\N_NN ઋતુઓનો\N_NN પ્રભાવ\N_NN કેવો\DM_DMQ રહેશે\V_VM ,\RD_PUNC તે\DM_DMD પ્રમાણે\PSP વૃક્ષો\N_NN ,\RD_PUNC વનસ્પતિ\N_NN ,\RD_PUNC અનાજનો\N_NN ઉછેર\N_NN કર્યો\V_VM .\RD_PUNC
GJRED150	સાથે\PSP ખેતી\N_NN માટે\PSP ઓજારો\N_NN બનાવી\V_VM આપ્યા\V_VM .\RD_PUNC
GJRED151	જંગલી\JJ પશુ\N_NN અને\CC_CCD જંગલી\JJ માણસોનું\N_NN રક્ષણ\N_NN થાય\V_VM .\RD_PUNC
GJRED152	દેવતાઓ\N_NN ,\RD_PUNC ત્રિદેવો\N_NN ,\RD_PUNC મનુષ્યો\N_NN ,\RD_PUNC સર્વના\JJ રક્ષણ\N_NN માટે\PSP અસ્ત્ર\N_NN શસ્ત્ર\N_NN બનાવી\V_VAUX_VNP આપ્યા\V_VM છે\V_VAUX .\RD_PUNC
GJRED153	વિશ્વકર્માએ\N_NNP વરદાનો\N_NN આપી\V_VAUX_VNP દૈત્યો\N_NN ,\RD_PUNC રાક્ષસોને\N_NN ,\RD_PUNC બળવાન\JJ બતાવ્યા\V_VM ન\RP_NEG હતા\V_VAUX .\RD_PUNC
GJRED154	ઔષધિઓ\N_NN ,\RD_PUNC મકાનો\N_NN ,\RD_PUNC મહેલો\N_NN ,\RD_PUNC ગુફાઓનું\N_NN નિર્માણ\N_NN કરી\V_VAUX_VNP સહુનું\JJ રક્ષણ\N_NN વિશ્વકર્માએ\N_NNP કર્યું\V_VM છે\V_VAUX .\RD_PUNC
GJRED155	આ\DM_DMD વિશ્વકર્માની\N_NN વિજ્ઞાનિક\JJ શોધ\N_NN છે\V_VAUX .\RD_PUNC
GJRED156	ઉપરાંત\PSP ઉતરાયણ\N_NN અને\CC_CCD દક્ષિણાયણના\N_NN સૂર્યની\N_NNP ગતિ\N_NN વિશ્વકર્માએ\N_NNP નક્કી\JJ કરી\V_VM છે\V_VAUX .\RD_PUNC
GJRED157	વિશ્વકર્મા\N_NNP પ્રભુએ\N_NN જગતના\N_NN લોકો\N_NN લાંબુ\JJ અને\CC_CCD નિરોગી\JJ આયુષ્ય\N_NN ભોગવે\V_VM તે\DM_DMD માટે\PSP અનેક\JJ પ્રકારની\N_NN ઔષધિ\N_NN દેવલોકમાંથી\N_NN લાવી\V_VAUX_VNP વાવેતર\N_NN કર્યું\V_VM .\RD_PUNC
GJRED158	તે\DM_DMD તેનો\PR_PRP જગત\N_NN ઉપર\PSP મોટો\JJ ઉપકાર\N_NN છે\V_VAUX .\RD_PUNC
GJRED159	આવા\JJ તો\RP_RPD તેમના\PR_PRP અનેક\JJ ઉપકાર\N_NN મનુષ્ય\N_NN અને\CC_CCD દેવો\N_NN ઉપર\PSP છે\V_VAUX .\RD_PUNC
GJRED160	આ\DM_DMD છે\V_VAUX વિશ્વકર્માની\N_NNP સર્વલોક\N_NN સુખી\JJ થવાની\V_VAUX_VNP ભાવના\N_NN મનુષ્ય\N_NN ખુદ\PR_PRF પોતાના\PR_PRF કાર્યોથી\N_NN સુખી\JJ થઈ\V_VM શકે\V_VAUX તે\DM_DMD ભાવના\N_NN મનુષ્ય\N_NN ખુદ\PR_PRF પોતાના\PR_PRF કરેલા\V_VAUX_VNP કાર્યોથી\N_NN અમર\JJ બની\V_VM શકે\V_VAUX ,\RD_PUNC દીર્ઘ\JJ આયુષ્ય\N_NN ભોગવવામાં\V_VAUX_VNP કામયાબ\JJ નીવડે\V_VM તે\DM_DMD આશા\N_NN અને\CC_CCD આકાંક્ષા\N_NN .\RD_PUNC
GJRED161	સહુ\JJ પ્રથમ\QT_QTO સૌરાષ્ટ્રમાં\N_NNP દક્ષિણ\N_NST કિનારે\N_NN સહુ\JJ પ્રથમ\QT_QTO આમ્રવૃક્ષ\N_NN ઉગાડ્યા\V_VM .\RD_PUNC
GJRED162	અમરકોષ\N_NNP નામના\N_NN ગ્રંથમાં\N_NN લખ્યું\V_VM છે\V_VAUX .\RD_PUNC
GJRED163	જ્ઞાન\N_NN એટલે\PSP મોક્ષની\N_NN બુદ્ધિ\N_NN .\RD_PUNC
GJRED164	વિજ્ઞાન\N_NN એટલે\PSP શિલ્પ\N_NN અને\CC_CCD તેના\DM_DMD માટે\PSP જે\PR_PRL ગ્રંથ\N_NN રચાણો\V_VM તે\DM_DMD સ્થાપત્યવેદ\N_NNP અથવા\CC_CCD અથર્વવેદ\N_NNP .\RD_PUNC
GJRED165	વિશ્વકર્માનાં\N_NNP શિલ્પ\N_NN શાસ્ત્રને\N_NN વેદ\N_NNP સંજ્ઞા\N_NN અપાય\V_VM છે\V_VAUX .\RD_PUNC
GJRED166	દરેક\JJ શિલ્પ\N_NN વિજ્ઞાનમાં\N_NN સંપૂર્ણ\JJ ફળ\N_NN આપે\V_VM છે\V_VAUX .\RD_PUNC
GJRED167	ઉત્તમ\JJ સુખ\N_NN સમૃદ્ધિ\N_NN આરોગ્ય\N_NN ,\RD_PUNC લાભ\N_NN અને\CC_CCD શાંતિ\N_NN આપનાર\V_VAUX_VNP થાય\V_VM તે\DM_DMD માટે\PSP વાસ્તુશાસ્ત્રની\N_NNP ભલામણ\N_NN કરવામાં\V_VAUX_VNP આવી\V_VAUX છે\V_VAUX .\RD_PUNC
GJRED168	વાસ્તુશાસ્ત્રના\N_NNP નિયમોને\N_NN આધીન\JJ રહીને\V_VAUX_VNP કાર્ય\N_NN કરવાથી\V_VAUX_VNP તે\DM_DMD સઘળા\JJ કર્મ\N_NN અને\CC_CCD કાર્યદોષ\N_NN મુક્ત\JJ થાય\V_VM છે\V_VAUX .\RD_PUNC
GJRED169	અને\CC_CCD વાપરનારને\V_VAUX_VNP ઉત્તમ\JJ ફળ\N_NN આપે\V_VM છે\V_VAUX .\RD_PUNC
GJRED170	તે\DM_DMD સઘળા\JJ નિયમો\N_NN મંદિરને\N_NN લગતા\V_VAUX_VNP નિયમો\N_NN ઘર\N_NN મહેલોને\N_NN લગતા\V_VAUX_VNP નિયમો\N_NN ,\RD_PUNC ગામ\N_NN શહેરને\N_NN લગતા\V_VAUX_VNP નિયમો\N_NN જે\PR_PRL કાયમી\JJ સુખ\N_NN આપનાર\V_VAUX_VNP રહે\V_VM છે\V_VAUX .\RD_PUNC
GJRED171	તે\DM_DMD પ્રમાણે\PSP વર્તન\N_NN કરવાથી\V_VAUX_VNP સઘળા\JJ મનોરથો\N_NN પૂરા\JJ થાય\V_VM છે\V_VAUX .\RD_PUNC
GJRED172	કારણકે\CC_CCS સર્વ\JJ સૃષ્ટિનું\N_NN નિર્માણ\N_NN કરતા\V_VAUX_VNP વિશ્વકર્મા\N_NNP છે\V_VAUX .\RD_PUNC
GJRED173	ભૂ\N_NN :\RD_PUNC એટલે\PSP ભૂમિનું\N_NN નિર્માણ\N_NN કરતા\V_VAUX_VNP હો\V_VAUX ઋષિમુનિઓ\N_NN વિશ્વકર્માને\N_NNP ભૂમાદેવ\N_NNP અથવા\CC_CCD ભૂમા\N_NNP ભગવાન\N_NNP કહે\V_VM છે\V_VAUX .\RD_PUNC
GJRED174	``\RD_PUNC ભૂમા\N_NNP ભગવાને\N_NNP ``\RD_PUNC ભાગવતમાં\N_NNP લખ્યું\V_VM છે\V_VAUX .\RD_PUNC
GJRED175	આપણા\PR_PRP શાસ્ત્રો\N_NN પુરાણો\N_NNP સાક્ષી\N_NN રૂપ\N_NN કહે\V_VM છે\V_VAUX ,\RD_PUNC ચોક્કસ\PSP મનોરથો\N_NN પૂરા\JJ કરે\V_VM છે\V_VAUX .\RD_PUNC
GJRED176	પણ\CC_CCD મનોરથો\N_NN સત્યની\N_NN એરણ\N_NN ઉપર\PSP ટીપાયેલ\V_VAUX_VNP અને\CC_CCD જીજ્ઞાસુ\N_NN વૃત્તિથી\N_NN કરેલ\V_VAUX_VNP હોય\V_VAUX .\RD_PUNC
GJRED177	આર્ત\N_NN પોકારે\V_VM કરેલા\V_VAUX_VNP કાર્યો\N_NN હંમેશાં\PSP સફળ\JJ રહે\V_VM છે\V_VAUX .\RD_PUNC
GJRED178	વિશ્વકર્મા\N_NNP વંશ\N_NN જ\RP_RPD દાદાનો\N_NN જીજ્ઞાસુ\JJ ભગત\N_NN છે\V_VAUX .\RD_PUNC
GJRED179	પણ\CC_CCD તે\DM_DMD ભક્તિ\N_NN સ્વાર્થી\JJ ન\RP_NEG હોવી\V_VAUX_VNP જોઈએ\V_VAUX .\RD_PUNC
GJRED180	વિરાટ\JJ પ્રભુ\N_NN જુઠી\JJ ભક્તિથી\N_NN ઘણા\QT_QTF દૂર\JJ રહે\V_VM છે\V_VAUX ,\RD_PUNC
GJRED181	આપણું\PR_PRP ચરિત્ર\N_NN શુદ્ધ\JJ હશે\V_VAUX ખાલી\JJ સ્વાર્થ\N_NN પુરતી\V_VAUX_VNP ભક્તિ\N_NN નહિ\RP_NEG કરી\V_VM હોય\V_VAUX તો\CC_CCD પ્રભુ\N_NN જરૂર\PSP મનના\N_NN મનોરથ\N_NN પૂરા\RB કરે\V_VM છે\V_VAUX .\RD_PUNC
GJRED182	સંપૂર્ણ\JJ કૃપા\N_NN ઉતારવી\V_VAUX_VNP હોય\V_VAUX તો\CC_CCD દાદાના\N_NN દરેક\JJ તહેવાર\N_NN આનંદ\N_NN અને\CC_CCD માનથી\N_NN ઉજવવા\V_VAUX_VNP .\RD_PUNC
GJRED183	સમૂહમાં\N_NN ઝાંખી\JJ કાઢવામાં\V_VAUX_VNP આવે\V_VAUX છે\V_VAUX .\RD_PUNC
GJRED184	તેમ\PSP વિશ્વકર્મા\N_NNP વંશજો\N_NN આંગણામાં\N_NN રંગોળી\N_NN પૂરી\JJ વિશ્વકર્મા\N_NNP પ્રભુનું\N_NNP આરતી\N_NN પૂજન\N_NN કરી\V_VM સમૂહમાં\N_NN શોભાયાત્રા\N_NN કાઢવી\V_VAUX_VNP .\RD_PUNC
GJRED185	તેની\DM_DMD કથા\N_NN કહી\V_VAUX_VNP દાદાના\N_NN ચારિત્રોની\N_NN લીલાની\N_NN કથા\N_NN કહેવી\V_VAUX_VNP .\RD_PUNC
GJRED186	આ\DM_DMD એક\QT_QTC જ\RP_RPD દાદાની\N_NN મોટી\JJ સેવા\N_NN છે\V_VAUX .\RD_PUNC
GJRED187	દાદા\N_NN વિશેનું\PSP સાહિત્ય\N_NN ગ્રંથો\N_NN રૂપિયા\N_NN કમાવા\V_VAUX_VNP ન\RP_NEG છપાવીએ\V_VM .\RD_PUNC
GJRED188	વિના\PSP મૂલ્યે\N_NN આપી\V_VAUX_VNP સમાજની\N_NN સેવા\N_NN કરીએ\V_VM .\RD_PUNC
GJRED189	કોઈની\DM_DMI જીજ્ઞાસા\N_NN સંતોષીએ\V_VM .\RD_PUNC
GJRED190	વિશ્વકર્મા\N_NNP પ્રભુ\N_NNP દ્વારા\PSP દ્વારિકા\N_NNP ,\RD_PUNC વૃંદાવન\N_NNP ,\RD_PUNC હસ્તીનાપુર\N_NNP ,\RD_PUNC ઈન્દ્રપ્રસ્થ\N_NNP લંકા\N_NNP વગેરે\PSP નગરીનું\N_NN નિર્માણ\N_NN કરેલું\V_VAUX_VNP .\RD_PUNC
GJRED191	દુનિયાભરના\N_NN તમામ\JJ દેશ\N_NN ,\RD_PUNC રાજ્ય\N_NN ,\RD_PUNC નાના\JJ મોટાં\JJ શહેર\N_NN ,\RD_PUNC નગર\N_NN અને\CC_CCD ગામ\N_NN ગામે\N_NN વણથંભ્યાં\JJ વિકાસ\N_NN કાર્યો\N_NN ચાલ્યા\V_VM જ\RP_RPD કરતા\V_VAUX_VNP હોય\V_VAUX છે\V_VAUX .\RD_PUNC
GJRED192	તે\DM_DMD ક્ષેત્રે\N_NN ઉપયોગી\JJ લાઈનના\N_NN નિષ્ણાત\JJ અભ્યાસુ\JJ સ્થપતિની\N_NN રાહબરીમાં\N_NN કારીગર\N_NN સમૂહદાય\N_NN અને\CC_CCD મજૂર\N_NN સહારે\N_NN ,\RD_PUNC રહેણાંક\N_NN વાણિજ્ય\N_NN અને\CC_CCD ઔદ્યોગિક\JJ ક્ષેત્રે\N_NN ઉપયોગી\JJ મકાનોનું\N_NN નિર્માણ\N_NN સદંતર\JJ ચાલ્યા\V_VAUX_VNP જ\RP_RPD કરે\V_VM છે\V_VAUX .\RD_PUNC
GJRED193	આ\DM_DMD વાત\N_NN તમામ\JJ સજીવોમાં\N_NN બુદ્ધિજીવી\JJ ગણાતા\V_VAUX_VNP માનવોની\N_NN થઈ\V_VM .\RD_PUNC
GJRED194	સતયુગમાં\N_NNP દેવોપયોગી\JJ બાંધકામ\N_NN સુવિધા\N_NN પૂરી\JJ પાડવાવાળા\JJ તે\DM_DMD જમાનાના\N_NN શ્રેષ્ઠતમ\JJ સ્થપતિ\N_NN એટલે\PSP જ\RP_RPD શ્રી\N_NN વિશ્વકર્મા\N_NNP પ્રભુ\N_NNP .\RD_PUNC
GJRED195	જગના\N_NN સજીવોના\N_NN જન્મ\N_NN ,\RD_PUNC પોષણ\N_NN અને\CC_CCD અંત\N_NN પ્રક્રિયાનું\N_NN સંચાલન\N_NN સંભાળતા\V_VAUX_VNP દેવો\N_NN એટલે\PSP બ્રહ્મા\N_NNP ,\RD_PUNC વિષ્ણુ\N_NNP અને\CC_CCD મહેશ\N_NNP .\RD_PUNC
GJRED196	સૃષ્ટિ\N_NN સર્જાયા\V_VAUX_VNP પૂર્વે\N_NST બ્રહ્માજીએ\N_NNP પોતાના\PR_PRF વિચારને\N_NN વિશ્વકર્માજીને\N_NNP સાથે\PSP ચર્ચેલો\V_VAUX_VNP તે\DM_DMD પછી\PSP તેઓશ્રીએ\PR_PRP જળમાં\N_NN ઈંડાનું\N_NN સ્થાપન\N_NN કરેલું\V_VAUX_VNP .\RD_PUNC
GJRED197	તે\DM_DMD અવિરત\JJ વધ્યા\V_VAUX_VNP જ\RP_RPD કર્યેથી\V_VAUX_VNP સમસ્ત\JJ બ્રહ્માંડની\N_NNP ઉત્પત્તિ\N_NN થઈ\V_VM .\RD_PUNC
GJRED198	પણ\CC_CCD તેમાં\DM_DMD સ્થિરતા\N_NN વર્તાતી\V_VAUX_VNP નહોતી\RP_NEG .\RD_PUNC
GJRED199	તે\DM_DMD અમલમાં\N_NN મુકાયેથી\V_VAUX_VNP હાલક\JJ ડોલક\JJ બ્રહ્માંડને\N_NNP સ્થિરતા\N_NN મળેલી\V_VAUX_VNP .\RD_PUNC
GJRED200	જેનો\PR_PRL આજનો\JJ કારીગર\N_NN વર્ગ\N_NN જે\PR_PRL તે\PR_PRL ધંધામાં\N_NN ઉપયોગ\N_NN કરી\V_VAUX_VNP તેને\DM_DMD આશીર્વાદ\N_NN સમ\JJ સ્વીકારી\V_VAUX_VNP તેઓશ્રીને\PR_PRP ઈષ્ટદેવ\N_NN સમજે\V_VM છે\V_VAUX .\RD_PUNC
GJRED201	વિશ્વકર્મા\N_NNP પ્રભુ\N_NNP દ્વારા\PSP દ્વારિકા\N_NNP ,\RD_PUNC વૃંદાવન\N_NNP ,\RD_PUNC હસ્તીનાપુર\N_NNP ,\RD_PUNC ઈન્દ્રપ્રસ્થ\N_NNP લંકા\N_NNP વગેરે\PSP નગરીનું\N_NN નિર્માણ\N_NN કરેલું\V_VAUX_VNP તે\DM_DMD ઉપરાંત\PSP શ્રી\N_NN રામચંદ્રને\N_NNP જરૂરી\JJ રામસેતુનું\N_NNP સર્જન\N_NN કરેલું\V_VAUX_VNP .\RD_PUNC
GJRED202	વળી\PSP રાજ\N_NN સિંહાસન\N_NN ,\RD_PUNC આભૂષણ\N_NN ,\RD_PUNC આયુધ\N_NN વાહન\N_NN અને\CC_CCD વિમાન\N_NN પણ\RP_RPD દેવો\N_NN કાજે\N_NST તૈયાર\JJ કરી\V_VAUX_VNP આપેલા\V_VAUX_VNP .\RD_PUNC
GJRED203	કર્મ\N_NN આધિન\JJ સૌ\JJ કોઈએ\PR_PRI તે\DM_DMD ભોગવવાં\V_VAUX_VNP પડે\V_VAUX છે\V_VAUX .\RD_PUNC
GJRED204	યુગ\N_NN પૂર્વે\N_NST થઈ\V_VM ગયેલ\V_VAUX_VNP પૃથુરાજાના\N_NNP રાજ્યમાં\N_NN જ્યારે\N_NST અનહદ\JJ અરાજકાતા\N_NN સાથે\PSP દુઃખ\N_NN છવાતું\V_VAUX_VNP રહ્યું\V_VAUX ત્યારે\N_NST ઋષિમુનિ\N_NN સમૂહે\N_NN મળી\V_VM પૃથુરાજાને\N_NNP તપ\N_NN કરી\V_VAUX_VNP ,\RD_PUNC સર્વ\JJ વિદ્યાસ્થાપક\N_NN તેમજ\CC_CCD તે\DM_DMD મુજબ\PSP સર્જન\N_NN કરવા\V_VAUX_VNP સક્ષમ\JJ શ્રેષ્ઠ\JJ શ્રી\N_NN વિશ્વકર્મા\N_NNP પ્રભુને\N_NNP પસંદ\JJ કરવા\V_VAUX_VNP કહેલું\V_VAUX_VNP .\RD_PUNC
GJRED205	પૃથુરાજાના\N_NNP કઠોર\JJ તપથી\N_NN પસંદ\JJ વિશ્વકર્માજીએ\N_NNP પૃથુરાજા\N_NNP અને\CC_CCD તેમની\PR_PRP પ્રજાના\N_NN દુઃખ\N_NN દૂર\JJ કર્યેથી\V_VAUX_VNP સુખની\N_NN વૃદ્ધિ\N_NN થઈ\V_VAUX .\RD_PUNC
GJRED206	થોડાંક\QT_QTF વર્ષોથી\N_NN સમાજના\N_NN સંપન્ન\JJ વર્ગમાં\N_NN ધ્યાન\N_NN પ્રચલિત\JJ થવા\V_VAUX_VNP માંડ્યું\V_VAUX છે\V_VAUX .\RD_PUNC
GJRED207	અને\CC_CCD એ\DM_DMD ય\RP_RPD વાત\N_NN ખરી\JJ કે\CC_CCS પહેલાં\N_NST ન\RP_NEG હતી\V_VAUX તેટલી\JJ આજે\N_NST ધ્યાનની\N_NN આવશ્યક્તા\N_NN ઊભી\JJ થઈ\V_VAUX છે\V_VAUX .\RD_PUNC
GJRED208	ધ્યાન\N_NN માટે\PSP વિવિધ\JJ સ્થળોએ\N_NN શિબિરો\N_NN યોજાય\V_VM છે\V_VAUX .\RD_PUNC
GJRED209	કેટલાક\QT_QTF લોકોએ\N_NN તો\RP_RPD સમયનો\N_NN પવન\N_NN પારખીને\V_VAUX_VNP તેને\DM_DMD થોડુંક\QT_QTF સજાવી\V_VAUX_VNP -\RD_PUNC ધજાવીને\V_VAUX_VNP વેપારી\N_NN ધોરણે\N_NN મૂક્યું\V_VM છે\V_VAUX .\RD_PUNC
GJRED210	તો\CC_CCD બીજી\JJ બાજુ\N_NST ધર્મના\N_NN સંપ્રદાયો\N_NN લોકોની\N_NN આવશ્યક્તા\N_NN નજરમાં\N_NN રાખીને\V_VAUX_VNP પોતપોતાના\PR_PRF ઢાળમાં\N_NN ઢાળીને\V_VAUX_VNP તેને\DM_DMD પોતાના\PR_PRF અનુયાયીઓ\N_NN પાસે\PSP રજૂ\JJ કરી\V_VM રહ્યા\V_VAUX છે\V_VAUX .\RD_PUNC
GJRED211	સમાજની\N_NN જરૂરિયાત\N_NN અને\CC_CCD લોકોની\N_NN વધતી\V_VAUX_VNP જિજ્ઞાસાને\N_NN ધ્યાનમાં\N_NN લઈને\V_VAUX_VNP મેં\PR_PRP થોડાક\N_NN વખત\N_NN પહેલાં\N_NST `\RD_PUNC ધ્યાન\N_NNP વિચાર\N_NNP `\RD_PUNC લખ્યું\V_VM .\RD_PUNC
GJRED212	જો\CC_CCD પોતાની\PR_PRF પ્રકૃતિને\N_NN લક્ષમાં\N_NN રાખીને\V_VAUX_VNP ધ્યાનની\N_NN પસંદગી\N_NN કરી\V_VM હશે\V_VAUX તો\CC_CCD ધ્યાન\N_NN ધરવું\V_VAUX_VNP સરળ\JJ રહેશે\V_VAUX અને\CC_CCD તેનો\DM_DMD લાભ\N_NN પણ\RP_RPD થોડાક\QT_QTF સમયમાં\N_NN જ\RP_RPD દેખાશે\V_VM .\RD_PUNC
GJRED213	આજકાલ\N_NST જે\PR_PRL ધ્યાનો\N_NN પ્રચલિત\JJ છે\V_VAUX તેમાં\DM_DMD પતંજલિના\N_NNP અષ્ટાંગ\JJ યોગનો\N_NN સમાવેશ\N_NN ભાગ્યે\PSP જ\RP_RPD કરવામાં\V_VAUX_VNP આવે\V_VAUX છે\V_VAUX .\RD_PUNC
GJRED214	અષ્ટાંગ\JJ યોગમાં\N_NN ધ્યાન\N_NN છે\V_VAUX પણ\CC_CCD તે\DM_DMD યોગના\N_NN એક\QT_QTC અંગ\N_NN તરીકે\PSP છે\V_VAUX .\RD_PUNC
GJRED215	ધ્યાન\N_NN યોગનું\N_NN સાતમું\QT_QTO અંગ\N_NN છે\V_VAUX અને\CC_CCD તે\DM_DMD કર્યા\V_VAUX_VNP પછી\PSP વિરમી\V_VM જવાનું\V_VAUX_VNP નથી\RP_NEG .\RD_PUNC
GJRED216	તેની\DM_DMD આગળ\PSP યોગનું\N_NN આઠમું\QT_QTO અંગ\N_NN સમાધિ\N_NN છે\V_VAUX .\RD_PUNC
GJRED217	જે\PR_PRL સિદ્ધ\JJ કરવા\V_VAUX_VNP માટે\PSP તો\RP_RPD આખો\JJ અષ્ટાંગ\JJ યોગ\N_NN છે\V_VAUX .\RD_PUNC
GJRED218	પતંજલિના\N_NNP યોગની\N_NN એ\DM_DMD વિશિષ્ટતા\N_NN છે\V_VAUX કે\CC_CCS તેઓ\PR_PRP ધ્યાનને\N_NN યોગથી\N_NN અલગ\JJ પાડતા\V_VAUX_VNP નથી\RP_NEG .\RD_PUNC
GJRED219	વાસ્તવિકતામાં\N_NN અષ્ટાંગ\JJ યોગ\N_NN સ્વસ્થ\JJ અને\CC_CCD સદાચારી\JJ જીવન\N_NN માટેનો\PSP છે\V_VAUX .\RD_PUNC
GJRED220	જે\PR_PRL પ્રાપ્ત\JJ કરવું\V_VAUX_VNP હોય\V_VAUX તો\CC_CCD યોગના\N_NN બધાં\QT_QTF અંગો\N_NN સાધવાં\V_VAUX_VNP પડે\V_VAUX .\RD_PUNC
GJRED221	એકલા\JJ ધ્યાનથી\N_NN ન\RP_NEG ચાલે\V_VM .\RD_PUNC
GJRED222	ખરેખર\PSP જોઈએ\V_VM તો\CC_CCD યોગના\N_NN આગલા\JJ છ\QT_QTC ચરણ\N_NN સાધ્યા\V_VAUX_VNP વિના\PSP ધ્યાનનું\N_NN સાતમું\QT_QTO અંગ\N_NN સિદ્ધ\JJ થાય\V_VM જ\RP_RPD નહિ\RP_NEG .\RD_PUNC
GJRED223	પંતજલિના\N_NNP અષ્ટાંગ\JJ યોગનું\N_NN અંતિમ\JJ ચરણ\N_NN સમાધિ\N_NN છે\V_VAUX .\RD_PUNC
GJRED224	સમાધિના\N_NN આપણે\PR_PRP બે\QT_QTC અર્થ\N_NN કાઢી\V_VM શકીએ\V_VAUX .\RD_PUNC
GJRED225	આપણે\PR_PRP તેને\DM_DMD આત્મા\N_NN પરમાત્મા\N_NN સાથેના\PSP મિલનની\N_NN અવસ્થા\N_NN તરીકે\PSP ઘટાડી\V_VM શકીએ\V_VAUX .\RD_PUNC
GJRED226	જો\CC_CCS સમાધિ\N_NN શબ્દને\N_NN પકડીને\V_VAUX_VNP જો\CC_CCD આપણે\PR_PRP આગળ\PSP વધીએ\V_VM તો\CC_CCD તેનો\DM_DMD એ\DM_DMD અર્થ\N_NN નીકળે\V_VM કે\CC_CCS તે\DM_DMD ચિત્તની\N_NN એવી\JJ સ્થિરતા\N_NN કે\CC_CCS જે\PR_PRL ચલાયમાન\JJ ન\RP_NEG થઈ\V_VM શકે\V_VAUX .\RD_PUNC
GJRED227	પતંજલિએ\N_NNP તેમના\PR_PRP યોગમાં\N_NN આત્મા\N_NN -\RD_PUNC પરમાત્માની\N_NN ઝાઝી\JJ વાત\N_NN કરી\V_VM નથી\RP_NEG .\RD_PUNC
GJRED228	વાસ્તવિકતામાં\N_NN સમાધિ\N_NN એ\DM_DMD અસ્તિત્વ\N_NN સાથેની\PSP તદ્રુપતાની\N_NN અવસ્થા\N_NN છે\V_VAUX .\RD_PUNC
GJRED229	ત્યાં\N_NST પહોંચ્યા\V_VAUX_VNP પછી\PSP કોઈ\DM_DMI વિષય\N_NN સાથે\PSP યોગ\N_NN જ\RP_RPD રહેતો\V_VAUX_VNP નથી\RP_NEG .\RD_PUNC
GJRED230	તાત્વિક\JJ રીતે\N_NN તે\DM_DMD અયોગની\N_NN અવસ્થા\N_NN છે\V_VAUX .\RD_PUNC
GJRED231	તેને\DM_DMD આત્મસ્થ\JJ અવસ્થા\N_NN પણ\RP_RPD કહી\V_VM શકાય\V_VAUX .\RD_PUNC
GJRED232	અસ્તિત્વ\N_NN સાથે\PSP અદ્વૈત\N_NN સધાયા\V_VAUX_VNP પછી\PSP કોઈ\DM_DMI સાધના\N_NN બાકી\JJ રહેતી\V_VAUX_VNP નથી\RP_NEG .\RD_PUNC
GJRED233	આ\DM_DMD અવસ્થા\N_NN વિશે\PSP કોઈ\DM_DMI કંઈ\DM_DMI કહી\V_VM શકતું\V_VAUX_VNP નથી\RP_NEG .\RD_PUNC
GJRED234	પરંતુ\CC_CCD તેના\DM_DMD વિશે\PSP જ્ઞાનીઓ\N_NN અહીં\N_NST તહીં\N_NST ઉલ્લેખો\N_NN કરે\V_VM છે\V_VAUX .\RD_PUNC
GJRED235	પતંજલિના\N_NNP અષ્ટાંગ\JJ યોગનાં\N_NN આઠ\QT_QTC અંગો\N_NN છે\V_VAUX .\RD_PUNC
GJRED236	યમ\N_NN ,\RD_PUNC નિયમ\N_NN ,\RD_PUNC આસન\N_NN ,\RD_PUNC પ્રાણાયામ\N_NN ,\RD_PUNC પ્રત્યાહાર\N_NN ,\RD_PUNC ધારણા\N_NN ,\RD_PUNC ધ્યાન\N_NN અને\CC_CCD સમાધિ\N_NN .\RD_PUNC
GJRED237	પતંજલિના\N_NNP અષ્ટાંગ\JJ યોગની\N_NN એ\DM_DMD જ\RP_RPD વિશિષ્ટતા\N_NN છે\V_VAUX .\RD_PUNC
GJRED238	તેઓ\PR_PRP એકેક\JJ પગલું\N_NN સ્થિર\JJ કર્યા\V_VAUX_VNP પછી\PSP જ\RP_RPD આગળ\PSP વધવામાં\V_VAUX_VNP માને\V_VM છે\V_VAUX .\RD_PUNC
GJRED239	જેથી\PSP એકવાર\PSP આગળ\PSP ગયા\V_VM પછી\PSP પાછા\RB પડવું\V_VAUX_VNP ન\RP_NEG પડે\V_VAUX .\RD_PUNC
GJRED240	યમમાં\N_NN નૈતિક\JJ આચાર\N_NN સંહિતા\N_NN આવે\V_VAUX છે\V_VAUX .\RD_PUNC
GJRED241	યોગના\N_NN બીજા\JJ દ્વારે\N_NN નિયમ\N_NN આવે\V_VAUX છે\V_VAUX .\RD_PUNC
GJRED242	વાસ્તવિકતામાં\N_NN તે\DM_DMD વ્રતો\N_NN છે\V_VAUX .\RD_PUNC
GJRED243	શૌચ\N_NN (\RD_SYM શારીરિક\JJ ,\RD_PUNC માનસિક\JJ અને\CC_CCD આત્મિક\JJ શુદ્ધિ\N_NN )\RD_SYM ,\RD_PUNC સંતોષ\N_NN (\RD_SYM સર્વ\JJ પ્રકારે\N_NN )\RD_SYM તપ\N_NN (\RD_SYM શરીરનું\N_NN ,\RD_PUNC વાણીનું\N_NN અને\CC_CCD મનનું\N_NN )\RD_SYM ,\RD_PUNC સ્વાધ્યાય\N_NN (\RD_SYM ધર્મગ્રંથોનો\N_NN અભ્યાસ\N_NN )\RD_SYM અને\CC_CCD ઈશ્વર\N_NN પ્રણિધાન\N_NN (\RD_SYM પરમાત્મા\N_NN પ્રતિનો\PSP સમર્પણ\N_NN ભાવ\N_NN )\RD_SYM .\RD_PUNC
GJRED244	યોગનું\N_NN ત્રીજું\QT_QTO અંગ\N_NN આસન\N_NN છે\V_VAUX .\RD_PUNC
GJRED245	પતંજલિએ\N_NNP શરીરની\N_NN સ્થિરતાને\N_NN ,\RD_PUNC ચિત્તની\N_NN એકાગ્રતા\N_NN માટે\PSP આવશ્યક\JJ ગણી\V_VM છે\V_VAUX .\RD_PUNC
GJRED246	પતંજલિએ\N_NNP સરળ\JJ આસનોની\N_NN જ\RP_RPD વાત\N_NN કરી\V_VM છે\V_VAUX .\RD_PUNC
GJRED247	કષ્ટદાયક\JJ આસનોનો\N_NN તેમાં\DM_DMD સમાવેશ\N_NN કર્યો\V_VM નથી\RP_NEG .\RD_PUNC
GJRED248	ત્યારપછી\PSP પ્રાણાયામ\N_NN આવે\V_VAUX છે\V_VAUX .\RD_PUNC
GJRED249	પ્રાણાયામમાં\N_NN શ્વાસને\N_NN સાધવાનો\V_VAUX_VNP છે\V_VAUX .\RD_PUNC
GJRED250	શ્વાસને\N_NN ચિત્ત\N_NN સાથે\PSP બહુ\QT_QTF નિકટનો\JJ સંબંધ\N_NN છે\V_VAUX .\RD_PUNC
GJRED251	શ્વાસ\N_NN એ\DM_DMD પ્રાણ\N_NN છે\V_VAUX .\RD_PUNC
GJRED252	પ્રાણને\N_NN સાધ્યા\V_VAUX_VNP વિના\PSP અધ્યાત્મના\N_NN ઊંચા\JJ શિખર\N_NN સુધીની\PSP યાત્રા\N_NN ન\RP_NEG થઈ\V_VM શકે\V_VAUX .\RD_PUNC
GJRED253	પ્રાણાયામમાં\N_NN મન\N_NN શાંત\JJ થઈ\V_VM જાય\V_VAUX છે\V_VAUX .\RD_PUNC
GJRED254	અષ્ટાંગ\JJ યોગમાં\N_NN પાંચમું\QT_QTO અંગ\N_NN પ્રત્યાહાર\N_NN છે\V_VAUX .\RD_PUNC
GJRED255	અષ્ટાંગ\JJ યોગનાં\N_NN પ્રથમ\QT_QTO ચાર\QT_QTC અંગનો\N_NN હેતુ\N_NN ચિત્તને\N_NN શુદ્ધ\JJ કરવા\V_VAUX_VNP માટેનો\PSP છે\V_VAUX .\RD_PUNC
GJRED256	યોગની\N_NN ખરી\JJ શરૂઆત\N_NN પ્રત્યાહારથી\N_NN થાય\V_VM છે\V_VAUX જે\PR_PRL સમાધિમાં\N_NN પહોંચીને\V_VAUX_VNP વિરમે\V_VM છે\V_VAUX .\RD_PUNC
GJRED257	ધારણા\N_NN એ\DM_DMD યોગનું\N_NN છઠ્ઠું\QT_QTO અંગ\N_NN છે\V_VAUX .\RD_PUNC
GJRED258	ધારણામાં\N_NN ચિત્તને\N_NN એક\QT_QTC વિષય\N_NN ઉપર\PSP કે\CC_CCS વિચાર\N_NN ઉપર\PSP કેન્દ્રિત\JJ કરવાની\V_VAUX_VNP વાત\N_NN છે\V_VAUX .\RD_PUNC
GJRED259	પતંજલિએ\N_NNP ધારણા\N_NN માટે\PSP વિધવિધ\JJ વિષયો\N_NN સૂચવ્યા\V_VM છે\V_VAUX .\RD_PUNC
GJRED260	ધારણા\N_NN આગળ\PSP વધતાં\V_VAUX_VNP સાધક\N_NN વિષયની\N_NN સાથે\PSP તદાકાર\JJ થતો\V_VAUX_VNP જાય\V_VAUX છે\V_VAUX .\RD_PUNC
GJRED261	ત્યારપછી\PSP ધ્યાન\N_NN આપે\V_VM છે\V_VAUX .\RD_PUNC
GJRED262	ધ્યાનથી\N_NN આત્માની\N_NN અનુભૂતિની\N_NN શરૂઆત\N_NN થાય\V_VM છે\V_VAUX અને\CC_CCD શરીરની\N_NN વિસ્મૃતિ\N_NN થવા\V_VAUX_VNP લાગે\V_VAUX છે\V_VAUX .\RD_PUNC
GJRED263	સમાધિમાં\N_NN ચિત્ત\N_NN અડોલ\JJ બની\V_VM જાય\V_VAUX છે\V_VAUX .\RD_PUNC
GJRED264	ત્યાં\N_NST તે\DM_DMD પોતાનામાં\PR_PRF જ\RP_RPD સ્થિતિ\N_NN કરીને\V_VAUX_VNP અસ્તિત્વનો\N_NN આનંદ\N_NN માણે\V_VM છે\V_VAUX .\RD_PUNC
GJRED265	તેને\DM_DMD પરમાત્મ\N_NN અવસ્થા\N_NN પણ\RP_RPD કહી\V_VM શકાય\V_VAUX .\RD_PUNC
GJRED266	પતંજલિના\N_NNP અષ્ટાંગ\JJ યોગની\N_NN આ\DM_DMD છે\V_VAUX આછી\JJ પાતળી\JJ રૂપરેખા\N_NN -\RD_PUNC વાસ્તવિકતામાં\N_NN અષ્ટાંગ\JJ યોગ\N_NN એ\DM_DMD સર્વાંગ\JJ યોગ\N_NN છે\V_VAUX .\RD_PUNC
GJRED267	તે\DM_DMD સંસારમાંથી\N_NN શરૂ\JJ થઈને\V_VAUX_VNP સમાધિમાં\N_NN જઈને\V_VAUX_VNP વિરમે\V_VM છે\V_VAUX .\RD_PUNC
GJRED268	જોયું\V_VM તો\RP_RPD છે\V_VAUX ને\CC_CCD વિવિધરંગી\JJ પુષ્પોથી\N_NN શોભતું\V_VAUX_VNP ઉદ્યાન\N_NN ?\RD_PUNC
GJRED269	ત્યાં\N_NST જાતજાતના\JJ વર્ણના\N_NN અને\CC_CCD અલગ\JJ અલગ\JJ પ્રકારના\N_NN ખુશ્બૂ\N_NN ધરાવતાં\V_VAUX_VNP ભાત\JJ -\RD_PUNC ભાતનાં\JJ પુષ્પો\N_NN ભલે\PSP હોય\V_VAUX ,\RD_PUNC પરંતુ\CC_CCD એ\DM_DMD સર્વમાં\JJ ગુલાબપુષ્પ\N_NN શિરમોર\JJ સ્થાન\N_NN આપોઆપ\PR_PRF હાંસલ\N_NN કરે\V_VM છે\V_VAUX .\RD_PUNC
GJRED270	કેમકે\CC_CCS સૌંદર્ય\N_NN -\RD_PUNC સુવાસ\N_NN -\RD_PUNC સુકોમળતાનો\N_NN અદભુત\JJ ત્રિવેણી\JJ સંગમ\N_NN હોય\V_VAUX છે\V_VAUX .\RD_PUNC
GJRED271	આ\DM_DMD વિશિષ્ટતા\N_NN જ\RP_RPD એને\DM_DMD શિરમોર\JJ સ્થાન\N_NN અપાવે\V_VM છે\V_VAUX .\RD_PUNC
GJRED272	જોયા\V_VAUX_VNP તો\RP_RPD છે\V_VAUX ને\RP_RPD ક્યારેક\N_NST રઢિયાળી\JJ રાતમાં\N_NN ચમકતાં\V_VAUX_VNP ચાંદ\N_NNP -\RD_PUNC તારા\N_NNP ?\RD_PUNC
GJRED273	કારણકે\CC_CCS ચન્દ્રમાં\N_NNP અધિક\JJ સૌમ્ય\N_NN પ્રકાશ\N_NN -\RD_PUNC ચાંદની\N_NN રેલાવવાની\V_VAUX_VNP ભરપૂર\JJ ક્ષમતા\N_NN હોય\V_VAUX છે\V_VAUX .\RD_PUNC
GJRED274	ચન્દ્રની\N_NNP આ\DM_DMD વિશિષ્ટતા\N_NN એને\DM_DMD સહુ\JJ વચ્ચે\N_NST ઉત્તમ\JJ સ્થાન\N_NN અપાવે\V_VM છે\V_VAUX .\RD_PUNC
GJRED275	એની\DM_DMD સર્વોપરિતા\N_NN તો\RP_RPD સર્વવિદિત\JJ છે\V_VAUX .\RD_PUNC
GJRED276	દિવસે\N_NN પ્રકાશ\N_NN ચાહે\PSP દિવાનો\N_NN હોય\V_VAUX કે\CC_CCS મશાલનો\N_NN હોય\V_VAUX ,\RD_PUNC મીણબત્તીનો\N_NN હોય\V_VAUX કે\CC_CCS `\RD_PUNC લાઈટનો\N_NN `\RD_PUNC હોય\V_VAUX :\RD_PUNC સૂર્યનું\N_NNP પ્રચંડ\JJ તેજ\N_NN આ\DM_DMD બધામાં\QT_QTF સર્વોપરિ\JJ સર્વશ્રેષ્ઠ\JJ આપોઆપ\PR_PRF બની\V_VM રહે\V_VAUX છે\V_VAUX .\RD_PUNC
GJRED277	કારણકે\CC_CCS એ\DM_DMD સ્વયં\PR_PRF પ્રખર\JJ તેજસ્વી\JJ હોવા\V_VAUX_VNP ઉપરાંત\PSP હજાર\N_NN -\RD_PUNC હજારથી\N_NN વધુ\QT_QTF તેજ\N_NN કિરણો\N_NN એ\DM_DMD અત્ર\N_NST -\RD_PUNC તત્ર\N_NST -\RD_PUNC સર્વત્ર\N_NST ફેલાવતો\V_VAUX_VNP રહે\V_VAUX છે\V_VAUX .\RD_PUNC
GJRED278	એની\DM_DMD આ\DM_DMD અદ્વિતીય\JJ વિશિષ્ટતા\N_NN જ\RP_RPD એને\DM_DMD પ્રકાશક\JJ પદાર્થોમાં\N_NN સર્વોચ્ચ\JJ -\RD_PUNC સર્વશ્રેષ્ઠ\JJ સ્થાન\N_NN અપાવે\V_VM છે\V_VAUX .\RD_PUNC
GJRED279	પુષ્પ\N_NN -\RD_PUNC ચન્દ્ર\N_NNP કે\CC_CCS સૂર્ય\N_NNP ચોક્કસ\JJ પ્રકારની\N_NN વિશિષ્ટતાનાં\N_NN કારણે\PSP શ્રેષ્ઠ\JJ સ્થાન\N_NN પામે\V_VM છે\V_VAUX .\RD_PUNC
GJRED280	એથી\PSP જ\RP_RPD છેલ્લા\JJ બે\QT_QTC લેખોથી\N_NN જે\PR_PRL ચાર\QT_QTC પ્રકારના\N_NN જીવોનું\N_NN સ્તર\N_NN વિચારીએ\V_VM છીએ\V_VAUX તેમાં\DM_DMD ચોથા\QT_QTO અને\CC_CCD સૌથી\JJ શ્રેષ્ઠ\JJ સ્તર\N_NN માટે\PSP શબ્દ\N_NN પ્રયોગ\N_NN છે\V_VAUX વિશિષ્ટ\JJ .\RD_PUNC
GJRED281	જે\PR_PRL જીવો\N_NN વિશિષ્ટ\JJ ગુણવત્તાસભર\JJ છે\V_VAUX તે\PR_PRL આ\DM_DMD ઉત્તમ\JJ કક્ષામાં\N_NN આવે\V_VAUX છે\V_VAUX .\RD_PUNC
GJRED282	વિશિષ્ટતા\N_NN એમની\PR_PRP અનેક\JJ પ્રકારની\N_NN હોઈ\V_VAUX શકે\V_VAUX છે\V_VAUX .\RD_PUNC
GJRED283	કોઈ\DM_DMI પ્રણિધાનનાં\N_NN કારણે\PSP વિશિષ્ટ\JJ હોય\V_VAUX ,\RD_PUNC કોઈ\DM_DMI પરિણતિનાં\N_NN કારણે\PSP વિશિષ્ટ\JJ હોય\V_VAUX ,\RD_PUNC તો\CC_CCD વળી\PSP કોઈ\DM_DMI વિનિયોગ\N_NN કૌશલ્યનાં\N_NN કારણે\PSP ય\RP_RPD વિશિષ્ટ\JJ હોય\V_VAUX .\RD_PUNC
GJRED284	વિશિષ્ટતાના\N_NN ચાર\QT_QTC માપદંડરૂપ\N_NN આ\DM_DMD ચાર\QT_QTC `\RD_PUNC ખની\N_NN `\RD_PUNC સંક્ષિપ્ત\JJ વિચારણા\N_NN આ\DM_DMD પ્રમાણે\PSP છે\V_VAUX :\RD_PUNC
GJRED285	આ\DM_DMD શબ્દ\N_NN મુખ્યત્વે\JJ જૈન\N_NN આરાધકવર્ગમાં\N_NN ખૂબ\QT_QTF ખૂબ\QT_QTF પ્રસિદ્ધ\JJ છે\V_VAUX .\RD_PUNC
GJRED286	આ\DM_DMD વ્યક્તિ\N_NN આરાધનાની\N_NN ખરી\JJ છે\V_VAUX .\RD_PUNC
GJRED287	પ્રસ્તુતમાં\JJ આપણે\PR_PRP જે\PR_PRL પ્રથમ\QT_QTO `\RD_PUNC ખ\N_NN `\RD_PUNC વિચારી\V_VM રહ્યા\V_VAUX છીએ\V_VAUX તેવો\JJ નિર્દેશ\N_NN એ\DM_DMD છે\V_VAUX કે\CC_CCS ઉત્તમ\JJ -\RD_PUNC વિશિષ્ટ\JJ સદગુણો\N_NN પ્રત્યે\PSP હાર્દિક\JJ આદર\N_NN લગાવ\N_NN ધરાવીને\V_VAUX_VNP અને\CC_CCD આત્મસાત્\JJ કરવા\V_VAUX_VNP .\RD_PUNC
GJRED288	દશ\QT_QTC દશ\QT_QTC કલાક\N_NN જ્ઞાનભ્યાસ\N_NN કરતી\V_VAUX_VNP વ્યક્તિ\N_NN જોઈને\V_VAUX_VNP .\RD_PUNC
GJRED289	હું\PR_PRP પણ\RP_RPD અવસરે\N_NN શક્તિ\N_NN મુજબનાં\PSP દાન\N_NN અવશ્ય\JJ કરીશ\V_VM .\RD_PUNC
GJRED290	હું\PR_PRP પણ\RP_RPD યથાશક્તિ\N_NN પર્વદિવસો\N_NN આદિમાં\PSP શીલવ્રતનું\N_NN પાલન\N_NN કરીશ\V_VM .\RD_PUNC
GJRED291	હું\PR_PRP પણ\RP_RPD શક્તિ\N_NN મુજબ\PSP રોજ\N_NST એકાદસણાદિનું\N_NN તપ\N_NN કરીશું\V_VM .\RD_PUNC
GJRED292	હું\PR_PRP પણ\RP_RPD વર્ષમાં\N_NN અમુક\PSP રકમ\N_NN અને\CC_CCD અમુક\PSP દિવસોની\N_NN સ્વૈચ્છિક\JJ સેવા\N_NN કરીશ\V_VM .\RD_PUNC
GJRED293	અમને\PR_PRP યાદ\V_VM આવે\V_VAUX છે\V_VAUX મુંબઈ\N_NNP -\RD_PUNC બોરીવલીના\N_NNP એક\QT_QTC ભાઈ\N_NN .\RD_PUNC
GJRED294	તેઓએ\PR_PRP એમને\PR_PRP ``\RD_PUNC મહારાજશ્રી\N_NNP !\RD_PUNC ``\RD_PUNC કહેલું\V_VAUX_VNP .\RD_PUNC
GJRED295	મુંબઈમાં\N_NNP જ્યાં\N_NST જ્યાં\N_NST દીક્ષામહોત્સવ\N_NN યોજાય\V_VM છે\V_VAUX .\RD_PUNC
GJRED296	ત્યાં\N_NST ત્યાં\N_NST હું\PR_PRP અચૂક\JJ ઉપસ્થિત\JJ રહેવાની\V_VAUX_VNP કોશિશ\N_NN કરું\V_VM છું\V_VAUX .\RD_PUNC
GJRED297	અને\CC_CCD દરેક\JJ દીક્ષા\N_NN મહોત્સવના\N_NN અંતે\N_NN ,\RD_PUNC મુમુક્ષના\N_NN વિરલ\JJ ત્યાગની\N_NN સક્રિય\JJ અનુમોદનાર્થે\N_NN કોઈ\DM_DMI એક\QT_QTC ત્યાગનિયમ\N_NN સ્વૈચ્છિકપણે\JJ આજીવન\JJ સ્વીકારું\V_VM છું\V_VAUX .\RD_PUNC
GJRED298	આજ\N_NST સુધીમાં\PSP આવા\JJ ૬૯\QT_QTC નિયમો\N_NN આજીવન\JJ થયા\V_VM છે\V_VAUX .\RD_PUNC
GJRED299	૧૦૮\QT_QTC થાય\V_VM એવી\JJ મારી\PR_PRP ભાવના\N_NN છે\V_VAUX !!!\N_NN
GJRED300	ખપીપણું\N_NN શું\PR_PRQ ચીજ\N_NN છે\V_VAUX આ\DM_DMD ભાગ્યવાનના\JJ શબ્દોમાં\N_NN ઝળકે\V_VM છે\V_VAUX .\RD_PUNC
GJRED301	ખાખીપણું\N_NN :\RD_PUNC જેની\PR_PRL જરૂરીયાત\N_NN અલ્પાતિઅલ્પ\JJ હોય\V_VAUX તેને\DM_DMD કહેવાય\V_VM `\RD_PUNC ખાખી\N_NN `\RD_PUNC .\RD_PUNC
GJRED302	આપણે\PR_PRP ત્યાં\N_NST આ\DM_DMD સંદર્ભમાં\N_NN જ\RP_RPD `\RD_PUNC ખાખીબાવા\N_NN `\RD_PUNC શબ્દપ્રયોગ\N_NN થાય\V_VM છે\V_VAUX .\RD_PUNC
GJRED303	અલબત્ત\PSP ,\RD_PUNC `\RD_PUNC બાવા\N_NN `\RD_PUNC અર્થાત્\PSP સાધુ\N_NN થવું\V_VAUX_VNP હજુ\N_NST કદાચ\PSP આસાન\JJ છે\V_VAUX .\RD_PUNC
GJRED304	પરંતુ\CC_CCD `\RD_PUNC ખાખીબાવા\N_NN `\RD_PUNC અર્થાત્\PSP નિઃસ્પૃહ\JJ સાધુ\N_NN બનવું\V_VAUX_VNP અતિ\JJ અતિ\JJ મુશ્કેલ\JJ છે\V_VAUX .\RD_PUNC
GJRED305	કેટલીક\QT_QTF વાર\N_NN બાહ્ય\JJ સંસાર\N_NN ત્યાગ્યા\V_VAUX_VNP પછી\PSP ય\RP_RPD પાછલા\JJ દ્વારેથી\N_NN સ્પૃહાઓનો\N_NN નવો\JJ સંસાર\N_NN જીવનમાં\N_NN પ્રવેશી\V_VM જતો\V_VAUX_VNP અનુભવાય\V_VM છે\V_VAUX .\RD_PUNC
GJRED306	`\RD_PUNC ખાખીપણું\N_NN `\RD_PUNC કેવું\DM_DMQ હોય\V_VAUX એ\DM_DMQ જાણવું\V_VAUX_VNP છે\V_VAUX ?\RD_PUNC
GJRED307	તો\CC_CCD વાંચો\V_VM અમારી\PR_PRP યશસ્વી\JJ ગુરુપરંપરાના\N_NN મૂર્ધન્ય\JJ સૂરિવર\JJ પૂ.\JJ નિસ્પૃહશિરોમણિ\JJ શ્રી\N_NN પ્રતાપસૂરીશ્વરજી\N_NNP મહારાજના\N_NN જીવનનો\N_NN આ\DM_DMD વિરલ\JJ પ્રસંગ\N_NN :\RD_PUNC
GJRED308	વિ.સં.\N_NN ૨૦૦૫ના\QT_QTC બનેલી\V_VAUX_VNP ઘટના\N_NN .\RD_PUNC
GJRED309	ત્યારના\N_NST મુંબઈના\N_NNP મુખ્ય\JJ ધર્મ\N_NN કેન્દ્ર\N_NN ગણાતાં\V_VAUX_VNP પાયધુની\N_NNP ગોડીજીસંઘમાં\N_NNP તેઓનું\PR_PRP ચાતુર્માસ\N_NN નિશ્ચિત\JJ થયું\V_VM હતું\V_VAUX .\RD_PUNC
GJRED310	મોટા\JJ આચાર્ય\N_NN અને\CC_CCD મોટો\JJ સંઘ\N_NN .\RD_PUNC
GJRED311	એટલે\PSP પ્રવેશના\N_NN સામૈયાં\N_NN માટે\PSP બેન્ડ\N_NN -\RD_PUNC સાંબેલા\N_NN વગેરે\PSP તૈયારી\N_NN વહેલાસર\JJ કરવાની\V_VAUX_VNP થઈ\V_VM .\RD_PUNC
GJRED312	પરંતુ\CC_CCD ગુરુદેવે\N_NN મોઘમ\JJ વાત\N_NN એક\JJ જ\RP_RPD કરી\V_VM .\RD_PUNC
GJRED313	``\RD_PUNC સમય\N_NN થશે\V_VM એટલે\PSP કહીશ\V_VM .\RD_PUNC ``\RD_PUNC
GJRED314	વિહાર\N_NN કરતાં\V_VAUX_VNP કરતાં\V_VAUX_VNP ગુરુદેવ\N_NN મોતીશા\N_NNP ભાયખલાઉપાશ્રય\N_NNP સુધી\PSP આવી\V_VM ગયા\V_VAUX .\RD_PUNC
GJRED315	પણ\CC_CCD પ્રવેશદિન\N_NN અંગે\PSP એ\DM_DMD જ\RP_RPD ઉત્તર\N_NST જારી\V_VM રાખ્યો\V_VAUX .\RD_PUNC
GJRED316	ટ્રસ્ટીઓ\N_NN મનોમન\N_NN મુંઝાતા\V_VAUX_VNP હતા\V_VAUX .\RD_PUNC
GJRED317	આજે\N_NST દોઢ\QT_QTC વાગ્યે\V_VM અમારો\PR_PRP ચાતુર્માસ\N_NN પ્રવેશ\N_NN છે\V_VAUX .\RD_PUNC
GJRED318	થોડો\QT_QTF સમય\N_NN તો\RP_RPD આપવો\V_VAUX_VNP હતો\V_VAUX ?\RD_PUNC
GJRED319	અમારે\PR_PRP સામૈયાની\N_NN જરૂર\N_NN જ\RP_RPD નથી\RP_NEG .\RD_PUNC
GJRED320	માટે\PSP તૈયારીનો\N_NN સમય\N_NN નથી\RP_NEG આપ્યો\V_VM .\RD_PUNC
GJRED321	અને\CC_CCD ખરેખર\PSP દોઢ\QT_QTC વાગ્યે\V_VM થોડા\QT_QTF ટ્રસ્ટીઓની\N_NN હાજરીમાં\N_NN કોઈ\DM_DMI જ\RP_RPD સામૈયાં\N_NN વિના\PSP એમણે\PR_PRP મુંબઈના\N_NNP મુખ્ય\JJ ધર્મસ્થાનમાં\N_NN ચાતુર્માસ\N_NN પ્રવેશ\N_NN કર્યો\V_VM !!\N_NN
GJRED322	અલબત્ત\PSP ,\RD_PUNC સામૈયું\N_NN અવસરે\N_NN શાસન\N_NN પ્રભાવનાનું\N_NN અંગ\N_NN હોવાથી\V_VAUX_VNP એની\DM_DMD નિતાંત\JJ ટીકાનો\N_NN અહીં\N_NST આશય\N_NN નથી\RP_NEG .\RD_PUNC
GJRED323	પરંતુ\CC_CCD નિસ્પૃહતા\N_NN શી\PR_PRQ ચીજ\N_NN છે\V_VAUX એની\DM_DMD સત્ય\JJ ઘટના\N_NN દર્શાવવાનો\V_VAUX_VNP અહીં\N_NST આશય\N_NN છે\V_VAUX .\RD_PUNC
GJRED324	આ\DM_DMD લઘુતાદર્શક\N_NN શબ્દપ્રયોગ\N_NN વગેરે\PSP અઢળક\N_NN બાબતો\N_NN એમનાં\PR_PRP જીવનમાં\N_NN ઝળહળતી\V_VAUX_VNP હતી\V_VAUX .\RD_PUNC
GJRED325	વસ્તુતઃ\PSP તેઓમાં\PR_PRP આરાધના\N_NN અંગે\PSP `\RD_PUNC ખરીપણું\N_NN `\RD_PUNC અને\CC_CCD જરૂરીયાતો\N_NN અંગે\PSP `\RD_PUNC ખાખીપણું\N_NN `\RD_PUNC પ્રથમ\QT_QTO નજરે\N_NN જણાઈ\V_VM આવે\V_VAUX તેવું\JJ સ્પષ્ટ\JJ હતું\V_VAUX .\RD_PUNC
GJRED326	ખુવારી\N_NN :\RD_PUNC વિશિષ્ટ\JJ વ્યક્તિના\N_NN માપદંડ\N_NN રૂપે\N_NN અમે\PR_PRP વિચારેલ\V_VAUX_VNP ત્રીજો\QT_QTO `\RD_PUNC ખ\N_NN `\RD_PUNC એટલે\PSP આ\DM_DMD ખુવારી\N_NN .\RD_PUNC
GJRED327	ખુવારીનો\N_NN અર્થ\N_NN છે\V_VAUX નુકશાની\N_NN યાવત્\PSP નાશ\N_NN .\RD_PUNC
GJRED328	નુકશાની\N_NN કે\CC_CCS નાશ\N_NN આમ\PSP તો\RP_RPD કોને\PR_PRQ ગમે\V_VM ,\RD_PUNC ભલા\PSP ?\RD_PUNC
GJRED329	છતાં\RP_RPD અહીં\N_NST ત્રીજા\QT_QTO માપદંડરૂપે\N_NN `\RD_PUNC ખુવારી\N_NN `\RD_PUNC શબ્દનો\N_NN પ્રયોગ\N_NN સમજપૂર્વક\JJ કરાયો\V_VM છે\V_VAUX .\RD_PUNC
GJRED330	અહીં\N_NST `\RD_PUNC ખુવારી\N_NN `\RD_PUNC દોષો\N_NN અંગે\PSP અભિપ્રેત\JJ છે\V_VAUX .\RD_PUNC
GJRED331	મતલબ\N_NN કે\CC_CCS વિશિષ્ટ\JJ કક્ષાની\N_NN વ્યક્તિએ\N_NN સતત\JJ આત્મનિરીક્ષણ\N_NN કરતાં\V_VAUX_VNP રહીને\V_VAUX_VNP દોષોની\N_NN ખુવારી\N_NN કરતાં\V_VAUX_VNP રહેવું\V_VAUX_VNP જોઈએ\V_VAUX .\RD_PUNC
GJRED332	મારા\PR_PRP જીવનમાં\N_NN જામી\V_VM ગયેલ\V_VAUX_VNP દોષોની\N_NN ટકાવારી\N_NN અને\CC_CCD તીવ્રતા\N_NN કેટલી\QT_QTF ઘટી\V_VM ?\RD_PUNC
GJRED333	મારા\PR_PRP કેટલા\QT_QTF દોષોનો\N_NN નાશ\N_NN થયો\V_VM ?\RD_PUNC
GJRED334	પવિત્ર\JJ અગ્રમગ્રન્થ\JJ `\RD_PUNC દશવૈકાલિકસૂત્રમાં\N_NNP `\RD_PUNC આનો\DM_DMD દિશાનિર્દેશ\N_NN કરતાં\V_VAUX_VNP આ\DM_DMD સાધનાસૂત્ર\N_NN અપાયું\V_VM છે\V_VAUX .\RD_PUNC
GJRED335	ખુમારી\N_NN :\RD_PUNC ખુમારી\N_NN એટલે\PSP સચ્ચાઈ\N_NN પ્રત્યે\PSP સારપ\N_NN પ્રત્યે\PSP -\RD_PUNC સિદ્ધાંત\N_NN પ્રત્યે\PSP ધગધગતું\V_VAUX_VNP ઊછળતું\V_VAUX_VNP શૌર્ય\N_NN .\RD_PUNC
GJRED336	અલબત્ત\PSP ,\RD_PUNC એમાં\DM_DMD અંધ\JJ ઝનૂન\N_NN કે\CC_CCS અન્યોને\JJ ઊતારી\V_VM પાડવાની\V_VAUX_VNP હલકી\JJ માનસિકતા\N_NN ચોક્કસપણે\JJ ન\RP_NEG જ\RP_RPD આવવી\V_VAUX_VNP જોઈએ\V_VAUX .\RD_PUNC
GJRED337	આજનો\JJ યુગ\N_NN બહુલતાએ\N_NN ખુમારીની\N_NN ખુવારીનો\N_NN યુગ\N_NN છે\V_VAUX .\RD_PUNC
GJRED338	એટલે\PSP જ\RP_RPD ઉઘાડેછોગ\JJ ચાલતાં\V_VAUX_VNP અત્યાચારો\N_NN બળાત્કારો\N_NN -\RD_PUNC ભ્રષ્ટાચારો\N_NN સામે\PSP અવાજ\N_NN ઉઠાવવાની\V_VAUX_VNP ય\RP_RPD કોઈ\DM_DMI લગભગ\PSP હિંમત\N_NN નથી\RP_NEG કરતું\V_VAUX_VNP .\RD_PUNC
GJRED339	એટલે\PSP વિશિષ્ટતાના\N_NN ચોથા\QT_QTO માપદંડરૂપે\N_NN અમે\PR_PRP ખુમારીને\N_NN સ્થાન\N_NN આપ્યું\V_VM છે\V_VAUX .\RD_PUNC
GJRED340	ખુમારી\N_NN કેવી\DM_DMQ ધગધગતી\V_VAUX_VNP હોય\V_VAUX એ\DM_DMD જાણવું\V_VAUX_VNP છે\V_VAUX ?\RD_PUNC
GJRED341	પૂના\N_NNP શહેરના\N_NN તે\DM_DMD સમયના\N_NN વિધાનસભ્ય\N_NN અને\CC_CCD જૈન\JJ અગ્રણી\JJ પોપટલાલ\N_NNP રામચંદ્ર\N_NNP શાહ\N_NNP .\RD_PUNC
GJRED342	એકવાર\PSP એ\PR_PRP આર્ય\N_NN સમાજના\N_NN ગુરુકુળની\N_NN મુલાકાતે\N_NN ગયા\V_VM .\RD_PUNC
GJRED343	મોટા\JJ થઈને\V_VAUX_VNP તમે\PR_PRP શું\PR_PRQ બનશો\V_VM ?\RD_PUNC
GJRED344	અમે\PR_PRP મોટા\JJ થઈને\V_VAUX_VNP શું\PR_PRQ બનીશું\V_VM એ\DM_DMD પછી\PSP વાત\N_NN .\RD_PUNC
GJRED345	પણ\CC_CCD તમે\PR_PRP જો\CC_CCD થોડા\QT_QTF દિવસ\N_NN અમારી\PR_PRP સાથે\PSP રહી\V_VM જાવ\V_VAUX તો\CC_CCD અમે\PR_PRP તમને\PR_PRP પાક્કા\JJ આર્યસમાજી\JJ બનાવી\V_VM દઈશું\V_VAUX એ\DM_DMD નક્કી\JJ !\RD_PUNC
GJRED346	છેલ્લી\JJ એક\QT_QTC મહત્ત્વની\JJ વાત\N_NN .\RD_PUNC
GJRED347	ભગવાન\N_NN શ્રીરામના\N_NNP નાના\JJ ભાઈ\N_NN ભરતને\N_NNP ભગવાન\N_NN શ્રીરામનો\N_NNP `\RD_PUNC વ્યૂહાવતાર\N_NN `\RD_PUNC માનવામાં\V_VAUX_VNP આવે\V_VAUX છે\V_VAUX .\RD_PUNC
GJRED348	ભરતનો\N_NNP અર્થ\N_NN થાય\V_VM છે\V_VAUX -\RD_PUNC વિશ્વનું\N_NN ભરણપોષણ\N_NN કરનાર\V_VAUX_VNP .\RD_PUNC
GJRED349	ભરતે\N_NNP એમનું\PR_PRP નામ\N_NN સાર્થક\JJ કર્યું\V_VM હતું\V_VAUX .\RD_PUNC
GJRED350	તેમને\PR_PRP બાળપણથી\N_NN જ\RP_RPD ભગવાન\N_NN રામ\N_NNP પ્રત્યે\PSP અપાર\JJ પ્રીતિ\N_NN હતી\V_VAUX .\RD_PUNC
GJRED351	તેમણે\PR_PRP જગતને\N_NN `\RD_PUNC ભ્રાતૃ\N_NN -\RD_PUNC પ્રેમનું\N_NN `\RD_PUNC અનન્ય\JJ ઉદાહરણ\N_NN પૂરું\JJ પાડ્યું\V_VM .\RD_PUNC `\RD_PUNC
GJRED352	તેમના\PR_PRP સુખમાં\N_NN જ\RP_RPD સુખના\N_NN આદર્શને\N_NN તેમણે\PR_PRP ચરિતાર્થ\JJ કર્યો\V_VM .\RD_PUNC
GJRED353	તે\PR_PRP રામના\N_NNP સુખમાં\N_NN જ\RP_RPD સુખી\JJ રહેતા\V_VAUX_VNP .\RD_PUNC
GJRED354	રામને\N_NNP અનુકૂળ\JJ આચરણ\N_NN કરવાનું\V_VAUX_VNP જ\RP_RPD તેમનું\PR_PRP જીવન\N_NN -\RD_PUNC ધ્યેય\N_NN હતું\V_VAUX .\RD_PUNC
GJRED355	ભગવાન\N_NN શ્રીરામને\N_NNP પણ\RP_RPD ભરત\N_NNP અતિપ્રિય\JJ હતા\V_VAUX .\RD_PUNC
GJRED356	એટલે\PSP જ\RP_RPD ગોસ્વામી\N_NN શ્રી\N_NN તુલસીદાસજીએ\N_NNP `\RD_PUNC રામચરિત\N_NNP માનસમાં\N_NNP `\RD_PUNC લખ્યું\V_VM છે\V_VAUX .\RD_PUNC
GJRED357	ભરત\N_NNP જેવો\JJ કોઈ\DM_DMI રામપ્રેમી\JJ નથી\RP_NEG .\RD_PUNC
GJRED358	ભરત\N_NNP જેવો\JJ રામસ્નેહી\JJ કોણ\PR_PRQ છે\V_VAUX ?\RD_PUNC
GJRED359	જે\PR_PRL જગતમાં\N_NN સતત\JJ રામ\N_NN -\RD_PUNC રામ\N_NN જાપ\N_NN કર્યા\V_VAUX_VNP જ\RP_RPD કરતો\V_VAUX_VNP હોય\V_VAUX એવો\JJ રામનો\N_NNP પ્રેમી\N_NN તો\RP_RPD ભરત\N_NNP સિવાય\PSP બીજો\JJ કોઈ\PR_PRI નથી\RP_NEG .\RD_PUNC
GJRED360	જ્યારે\N_NST ભરતને\N_NNP ખબર\N_NN પડી\V_VM કે\CC_CCS રામ\N_NNP ,\RD_PUNC લક્ષ્મણ\N_NNP અને\CC_CCD જાનકીને\N_NNP વનવાસ\N_NN ભોગવવાનું\V_VAUX_VNP અને\CC_CCD પિતાના\N_NN મરણનું\N_NN કારણ\N_NN તે\PR_PRP પોતે\PR_PRF જ\RP_RPD છે\V_VAUX ત્યારે\N_NST પારાવાર\JJ દુઃખ\N_NN થયું\V_VM .\RD_PUNC
GJRED361	પોતાની\PR_PRF સગી\JJ માતા\N_NN કૈકેયી\N_NNP કૌશલ્યા\N_NNP અને\CC_CCD સુમિત્રાની\N_NNP વચ્ચે\N_NST ઊભી\V_VM હતી\V_VAUX .\RD_PUNC
GJRED362	આ\DM_DMD નિહાળીને\V_VAUX_VNP તે\DM_DMD બોલી\V_VM ઊઠ્યા\V_VM મારી\PR_PRP આ\DM_DMD માતા\N_NN કૌશલ્યા\N_NNP અને\CC_CCD આ\DM_DMD માતા\N_NN સુમિત્રાની\N_NNP વચ્ચે\N_NST ઊભી\V_VM રહેલી\V_VAUX_VNP તું\PR_PRP જરાય\QT_QTF શોભતી\V_VAUX_VNP નથી\RP_NEG !\RD_PUNC
GJRED363	ભરત\N_NNP દયાવાન\JJ પણ\RP_RPD હતા\V_VAUX .\RD_PUNC
GJRED364	તેમણે\PR_PRP કૈકયઈ\N_NNP અને\CC_CCD મન્થરાને\N_NNP કડવા\JJ શબ્દો\N_NN સંભળાવ્યા\V_VM .\RD_PUNC
GJRED365	પોતાનું\PR_PRF અનિષ્ટ\JJ કરનાર\V_VAUX_VNP પરત્વે\PSP પણ\RP_RPD દયાભાવ\N_NN રાખવો\V_VAUX_VNP .\RD_PUNC
GJRED366	ભરતને\N_NNP પણ\RP_RPD આવા\JJ સંત\N_NN માનવા\V_VAUX_VNP પડે\V_VAUX .\RD_PUNC
GJRED367	ભરતે\N_NNP ખૂબ\QT_QTF ધીરજપૂર્વક\RB પિતાની\N_NN ઔર્ધ્વદેહિક\JJ ક્રિયાઓ\N_NN પૂરી\JJ કરી\V_VM .\RD_PUNC
GJRED368	ભરતે\N_NNP ગુરુ\N_NN વસિષ્ઠ\N_NNP અને\CC_CCD માતા\N_NN કૌશલ્યાના\N_NNP સમજાવવા\V_VAUX_VNP છતાં\RP_RPD રાજ્ય\N_NN ગ્રહણ\N_NN ના\RP_NEG કર્યું\V_VM .\RD_PUNC
GJRED369	તે\DM_DMD પણ\RP_RPD તે\PR_PRP ભૂલ્યા\V_VM નહીં\RP_NEG .\RD_PUNC
GJRED370	વનમાં\N_NN જતી\V_VAUX_VNP વખતે\N_NN રસ્તામાં\N_NN એમની\PR_PRP દશા\N_NN બહુ\QT_QTF દયનીય\JJ હતી\V_VAUX .\RD_PUNC
GJRED371	શૃંગવેરપુર\N_NNP પહોંચીને\V_VAUX_VNP તે\PR_PRP નિષાદરાજગૃહને\N_NNP રામના\N_NNP અનન્ય\JJ પ્રેમી\N_NN જાણીને\V_VAUX_VNP એમને\PR_PRP બહુ\QT_QTF પ્રેમથી\N_NN મળે\V_VM છે\V_VAUX .\RD_PUNC
GJRED372	બધા\QT_QTF પ્રકારની\N_NN સવારીની\N_NN સગવડ\N_NN જોડે\PSP જ\RP_RPD હોવા\V_VAUX_VNP છતાં\RP_RPD તે\PR_PRP વનમાં\N_NN પગપાળા\RB જ\RP_RPD જાય\V_VM છે\V_VAUX .\RD_PUNC
GJRED373	કેમકે\CC_CCS તે\PR_PRP વિચારે\V_VM છે\V_VAUX કે\CC_CCS મારા\PR_PRP કારણે\PSP મારા\PR_PRP સ્વામી\N_NN રામ\N_NNP વનમાં\N_NN પગપાળા\RB ચાલે\V_VM છે\V_VAUX .\RD_PUNC
GJRED374	તો\CC_CCD મારાથી\PR_PRP સવારી\N_NN પર\PSP કેમ\DM_DMQ બેસાય\V_VM ?\RD_PUNC
GJRED375	કોઈએ\PR_PRI બહુ\QT_QTF આગ્રહ\N_NN કર્યો\V_VM તો\CC_CCD કહેવા\V_VAUX_VNP લાગ્યા\V_VAUX મારા\PR_PRP માટે\PSP યોગ્ય\JJ તો\RP_RPD એ\DM_DMD છે\V_VAUX કે\CC_CCS હું\PR_PRP ઊંધા\JJ માથે\N_NN ચાલીને\V_VAUX_VNP ભગવાનની\N_NN પાસે\PSP જઉં\V_VM !\RD_PUNC
GJRED376	ક્યારેય\N_NST ખુલ્લા\JJ પગે\N_NN ચાલ્યા\V_VM ન\RP_NEG હોવાથી\V_VAUX_VNP જ્યારે\N_NST વનમાં\N_NN ખુલ્લા\JJ પગે\N_NN ચાલીને\V_VAUX_VNP રામને\N_NNP મળવા\V_VAUX_VNP જાય\V_VAUX છે\V_VAUX .\RD_PUNC
GJRED377	ત્યારે\N_NST પગના\N_NN તળિયામાં\N_NN ફોલ્લા\N_NN પડી\V_VM જાય\V_VAUX છે\V_VAUX .\RD_PUNC
GJRED378	તોય\RP_RPD તેની\DM_DMD પરવા\N_NN કરતા\V_VAUX_VNP નથી\RP_NEG .\RD_PUNC
GJRED379	ભરત\N_NNP ચિત્રકુટ\N_NNP પાસે\PSP પહોંચી\V_VM જાય\V_VAUX છે\V_VAUX .\RD_PUNC
GJRED380	આ\DM_DMD પ્રસંગે\N_NN ભગવાન\N_NN શ્રીરામે\N_NNP પોતાના\PR_PRF મુખે\N_NN ભરતના\N_NNP મુક્ત\JJ કંઠે\N_NN વખાણ\N_NN કર્યા\V_VM છે\V_VAUX .\RD_PUNC
GJRED381	ભરત\N_NNP સમાન\JJ શીલવાન\JJ ભાઈ\N_NN વિધાતાની\N_NN સૃષ્ટિમાં\N_NN કોઈ\PR_PRI જોયો\V_VM નથી\RP_NEG .\RD_PUNC
GJRED382	ભરતને\N_NNP અયોધ્યાનું\N_NNP રાજ્ય\N_NN તો\RP_RPD શું\PR_PRQ બ્રહ્મલોક\N_NNP ,\RD_PUNC વૈકુંઠ\N_NNP કે\CC_CCS શિવલોક\N_NNP પ્રાપ્ત\JJ થાય\V_VM .\RD_PUNC
GJRED383	તોય\RP_RPD કોઈ\DM_DMI વિકાર\N_NN ના\RP_NEG થાય\V_VM .\RD_PUNC
GJRED384	ભરત\N_NNP ચિત્રકૂટની\N_NNP અત્યંત\JJ લગોલગ\PSP પહોંચી\V_VM જાય\V_VAUX છે\V_VAUX .\RD_PUNC
GJRED385	તે\DM_DMD સાથે\PSP જ\RP_RPD તે\DM_DMD તે\DM_DMD જગ્યાએ\N_NN ધૂળમાં\N_NN આળોટવા\V_VAUX_VNP લાગે\V_VAUX છે\V_VAUX  .\RD_PUNC
GJRED386	રામ\N_NNP ભરતને\N_NNP ઉમળકાભેર\JJ ભેટી\V_VM પડે\V_VAUX છે\V_VAUX .\RD_PUNC
GJRED387	અથવા\CC_CCD લક્ષ્મણને\N_NNP અયોધ્યા\N_NNP મોકલી\V_VM દો\V_VAUX અને\CC_CCD મને\PR_PRP એમની\PR_PRP જગ્યાએ\N_NN વનવાસમાં\N_NN સાથે\PSP લઈ\V_VM લો\V_VAUX !\RD_PUNC
GJRED388	તું\PR_PRP માંગે\V_VM તો\RP_RPD મારા\PR_PRP પ્રાણ\N_NN પણ\RP_RPD આપી\V_VM દઉં\V_VAUX .\RD_PUNC
GJRED389	તું\PR_PRP કહે\V_VM તો\RP_RPD હું\PR_PRP કરુ\V_VM પણ\CC_CCD આ\DM_DMD સંજોગોમાં\N_NN આપણાથી\PR_PRP એવું\JJ કરાય\V_VM નહીં\RP_NEG .\RD_PUNC
GJRED390	નહીંતર\RP_NEG પિતાજીને\N_NN આપેલું\V_VAUX_VNP છેલ્લું\JJ વચન\N_NN મેં\PR_PRP તોડ્યું\V_VM એમ\PSP કહેવાય\V_VM !\RD_PUNC
GJRED391	ત્યારે\N_NST ભરત\N_NNP માની\V_VM ગયા\V_VAUX અને\CC_CCD ભગવાન\N_NN શ્રીરામની\N_NNP પાદુકા\N_NN માંગી\V_VM ભારે\JJ હૈયે\N_NN પાછા\RB ફર્યા\V_VM .\RD_PUNC
GJRED392	એ\DM_DMD પાદુકાને\N_NN જ\RP_RPD રાજ\N_NN સિંહાસન\N_NN પર\PSP પ્રસ્થાપિત\JJ કરી\V_VM .\RD_PUNC
GJRED393	અનુપમ\JJ અને\CC_CCD અણમોલ\JJ આ\DM_DMD વસુંધરાને\N_NN ખોળે\N_NN ભાત\N_NN -\RD_PUNC ભાતના\N_NN પ્રદેશો\N_NN છે\V_VAUX .\RD_PUNC
GJRED394	એમાં\DM_DMD શિરમોર\JJ છે\V_VAUX આ\DM_DMD ભારતની\N_NNP ભાગ્યવંત\JJ ભૂમિ\N_NN .\RD_PUNC
GJRED395	જે\PR_PRL ભૂમિની\N_NN પરથારે\N_NN પરમ\JJ કૃપાળુ\JJ ભગવાનનાં\N_NN અવતરણનું\N_NN સૌભાગ્ય\N_NN લખ્યું\V_VM છે\V_VAUX .\RD_PUNC
GJRED396	જે\PR_PRL ભૂમિના\N_NN ખોળે\N_NN અનંત\JJ સમર્થ\JJ સંતો\N_NN વિભૂતિઓનું\N_NN પ્રાગટ્ય\N_NN થયું\V_VM છે\V_VAUX અને\CC_CCD થાય\V_VM છે\V_VAUX .\RD_PUNC
GJRED397	આ\DM_DMD ભારત\N_NNP માતાનો\N_NN પાલવ\N_NN પકડીને\V_VAUX_VNP કેટલાય\QT_QTF બ્રહ્મનિષ્ઠ\JJ સંતો\N_NN -\RD_PUNC ભક્તો\N_NN અહર્નિશ\JJ ખેલે\V_VM છે\V_VAUX .\RD_PUNC
GJRED398	ગુજરાતમાં\N_NNP અને\CC_CCD સારાય\JJ ભારતમાં\N_NNP ચારિત્ર્ય\N_NN ઘડતર\N_NN કરવામાં\V_VAUX_VNP અનેક\JJ સંતો\N_NN અને\CC_CCD સંપ્રદાયનો\N_NN ફાળો\N_NN છે\V_VAUX .\RD_PUNC
GJRED399	જેમાં\PR_PRL સ્વામિનારાયણ\N_NNP સંપ્રદાયનો\N_NNP ફાળો\N_NN છે\V_VAUX પણ\CC_CCD આ\DM_DMD ભગીરથ\JJ કાર્યમાં\N_NN આંખે\N_NN આવીને\V_VAUX_VNP વળગે\V_VM તેવો\JJ છે\V_VAUX .\RD_PUNC
GJRED400	શ્રીસ્વામિનારાયણ\N_NNP ભગવાને\N_NNP અને\CC_CCD તેમના\PR_PRP સંતોએ\N_NN ગુજરાતને\N_NNP બે\QT_QTC બે\QT_QTC સદીથી\N_NN ધર્મનાં\N_NN પીયૂષ\N_NN પીવડાવ્યાં\V_VM છે\V_VAUX .\RD_PUNC
GJRED401	આ\DM_DMD સ્વામિનારાયણ\N_NNP સંપ્રદાયે\N_NNP ગુજરાતીઓના\N_NN જીવ\N_NN સુધી\PSP પહોંચતી\V_VAUX_VNP વ્યસનોની\N_NN પગરવાટને\N_NN ભૂંસી\V_VM છે\V_VAUX .\RD_PUNC
GJRED402	અણમોલ\JJ મોતી\N_NN જેવા\JJ માનવો\N_NN આ\DM_DMD ગુજરાતની\N_NNP ધરતીના\N_NN ચરણે\N_NN ધરી\V_VM દેવાનું\V_VAUX_VNP આ\DM_DMD સંપ્રદાયનું\N_NN કર્તવ્ય\N_NN રહ્યું\V_VAUX છે\V_VAUX .\RD_PUNC
GJRED403	કેવું\DM_DMQ હતું\V_VAUX તેમનું\PR_PRP સામર્થ્ય\N_NN !\RD_PUNC
GJRED404	કેવો\DM_DMQ હતો\V_VAUX તેમનો\PR_PRP પ્રૌઢ\JJ પ્રતાપ\N_NN !\RD_PUNC
GJRED405	કેવા\DM_DMQ હતા\V_VAUX તેમના\PR_PRP કાર્યો\N_NN તે\DM_DMD જાણવાં\V_VAUX_VNP અને\CC_CCD માણવાં\V_VAUX_VNP જેવાં\JJ છે\V_VAUX .\RD_PUNC
GJRED406	તેમના\PR_PRP જીવનચરિત્રોના\N_NN સંપ્રદાયમાં\N_NN દળદાર\JJ ગ્રંથોના\N_NN ગ્રંથો\N_NN લખાયા\V_VM છે\V_VAUX .\RD_PUNC
GJRED407	પરંતુ\CC_CCD આપણે\PR_PRP અત્રે\N_NST ``\RD_PUNC સિંધુમાંથી\N_NN ``\RD_PUNC માત્ર\RP_RPD ``\RD_PUNC બિંદુ\N_NN ``\RD_PUNC જેટલું\JJ જ\RP_RPD જગ્યાના\N_NN અભાવે\N_NN જાણી\V_VM શકીશું\V_VAUX .\RD_PUNC
GJRED408	તો\CC_CCD વાંચો\V_VM સ્વામિનારાયણ\N_NNP સંપ્રદાયને\N_NNP કંડારનાર\V_VAUX_VNP સમર્થ\JJ અગિયાર\QT_QTC શીલ્પીઓ\N_NN જીવન\N_NN ગાથા\N_NN .\RD_PUNC
GJRED409	એ\DM_DMD સ્વામીઓના\N_NN જીવનચરિત્રો\N_NN અહીં\N_NST રજૂ\V_VM કર્યા\V_VAUX છે\V_VAUX .\RD_PUNC
GJRED410	આ\DM_DMD સ્વામિનારાયણ\N_NNP સંપ્રદાયના\N_NNP પ્રવર્તનના\N_NN કાર્યમાં\N_NN અનેક\JJ સંતોનો\N_NN ફાળો\N_NN છે\V_VAUX .\RD_PUNC
GJRED411	પરંતુ\CC_CCD સૌથી\JJ વધુ\QT_QTF ફાળો\N_NN તેમના\PR_PRP સંતમંડળના\N_NN ગોપાળાનંદ\N_NNP સ્વામીનો\N_NNP રહ્યો\V_VAUX છે\V_VAUX .\RD_PUNC
GJRED412	આકાશના\N_NN અનંત\JJ તારાઓમાં\N_NN કોઈક\DM_DMI વિશેષ\JJ તેજસ્વી\JJ હોય\V_VAUX છે\V_VAUX .\RD_PUNC
GJRED413	તેમ\PSP સહજાનંદ\N_NNP સિંધુની\N_NN અનેક\JJ નદીઓમાં\N_NN શ્રીજી\N_NN સંકલ્પ\N_NN મૂર્તિ\N_NN શ્રી\N_NN ગોપાળાનંદ\N_NNP સ્વામીએ\N_NNP સૌથી\JJ શ્રેષ્ઠ\JJ સરિતા\N_NN સમાન\JJ છે\V_VAUX .\RD_PUNC
GJRED414	સ્વામિનારાયણ\N_NNP સંપ્રદાય\N_NNP મુખ્ય\JJ બે\QT_QTC દેશ\N_NN ને\CC_CCD બે\QT_QTC ગાદી\N_NN દ્વારા\PSP વહેંચાયો\V_VM હતો\V_VAUX .\RD_PUNC
GJRED415	બંને\JJ દેશના\N_NN અયોધ્યાપ્રસાદજી\N_NNP મહારાજ\N_NNP અને\V_VM રઘુવીરજી\N_NNP મહારાજ\N_NNP એમ\PSP આચાર્યો\N_NN હોવા\V_VAUX_VNP છતાંય\RP_RPD સર્વના\JJ ઉપરી\N_NN તરીકે\PSP સદગુરુ\N_NN શ્રી\N_NN ગોપાળાનંદ\N_NNP સ્વામીને\N_NNP શ્રી\N_NN સ્વામિનારાયણ\N_NNP ભગવાને\N_NNP સ્થાપ્યા\V_VM .\RD_PUNC
GJRED416	સાધુ\N_NN વર્ણીપાળા\N_NN સાંભળજો\V_VM અને\CC_CCD ગોપાળમુનિની\N_NNP આજ્ઞામાં\N_NN રહેજો\V_VAUX .\RD_PUNC
GJRED417	સદ્.\JJ શ્રી\N_NN ગોપાળાનંદ\N_NNP સ્વામીને\N_NNP શ્રી\N_NN સ્વામિનારાયણ\N_NNP ભગવાને\N_NNP અપાર\JJ ઐશ્વર્ય\N_NN સામર્થ્ય\N_NN આપ્યું\V_VM હતું\V_VAUX .\RD_PUNC
GJRED418	જેમ\PSP શ્રી\N_NN સ્વામિનારાયણ\N_NNP ભગવાન\N_NNP જે\PR_PRL ધારે\V_VM તે\PR_PRL કાર્ય\N_NN કરી\V_VM શકે\V_VAUX તેમ\PSP સદગુરુ\N_NN શ્રી\N_NN ગોપાળાનંદ\N_NNP સ્વામી\N_NNP સંકલ્પ\N_NN માત્રમાં\RP_RPD ધારે\V_VM તે\DM_DMD કરવા\V_VAUX_VNP સમર્થ\JJ હતા\V_VAUX .\RD_PUNC
GJRED419	સ્વામીનો\N_NN સ્વભાવ\N_NN ખૂબ\QT_QTF જ\RP_RPD દયાળુ\JJ હતો\V_VAUX .\RD_PUNC
GJRED420	કોઈ\DM_DMI દીન\JJ -\RD_SYM દુખીયા\JJ આવી\V_VM પ્રાર્થના\N_NN કરે\V_VM તો\CC_CCD તેને\DM_DMD વ્યવહારે\N_NN સુખિયા\JJ કરતાં\V_VAUX_VNP .\RD_PUNC
GJRED421	કોઈ\PR_PRI અન્ન\N_NN ,\RD_PUNC ધન\N_NN ,\RD_PUNC વસ્ત્રની\N_NN આજીજી\N_NN કરતા\V_VAUX_VNP તો\CC_CCD કોઈ\PR_PRI વરસાદની\N_NN માંગણી\N_NN કરતા\V_VAUX_VNP તો\CC_CCD સ્વામી\N_NN કૃપા\N_NN કરી\V_VM પ્રાર્થના\N_NN સ્વીકારી\V_VM સૌને\JJ રાજી\JJ કરતા\V_VAUX_VNP .\RD_PUNC
GJRED422	એમની\PR_PRP પાસે\PSP રડતાં\V_VAUX_VNP આવનાર\V_VAUX_VNP હસતાં\V_VAUX_VNP મુખે\N_NN પાછા\RB ફરતા\V_VAUX_VNP .\RD_PUNC
GJRED423	પછી\PSP તે\DM_DMD હિન્દુ\N_NN હોય\V_VAUX કે\CC_CCS ,\RD_PUNC મુસલમાન\N_NN હોય\V_VAUX કે\CC_CCS પારસી\N_NN હોય\V_VAUX કોઈ\DM_DMI પણ\RP_RPD જાતિનો\N_NN હોય\V_VAUX સૌને\JJ એમ\PSP લાગતું\V_VAUX_VNP કે\CC_CCS ,\RD_PUNC આ\DM_DMD ગોપાળનંદસ્વામી\N_NNP અમારા\PR_PRP છે\V_VAUX .\RD_PUNC
GJRED424	કોઈ\PR_PRI પણ\RP_RPD જીવના\N_NN કામ\N_NN ,\RD_PUNC ક્રોધ\N_NN ,\RD_PUNC લોભ\N_NN ,\RD_PUNC મોહ\N_NN ,\RD_PUNC મદ\N_NN ,\RD_PUNC મત્સર\N_NN ,\RD_PUNC આશા\N_NN ,\RD_PUNC તૃષ્ણા\N_NN ,\RD_PUNC વાસના\N_NN આદિ\PSP દોષો\N_NN પણ\RP_RPD તરત\PSP તેઓ\PR_PRP ટાળી\V_VM નાખતા\V_VAUX_VNP .\RD_PUNC
GJRED425	રાજકોટની\N_NNP અંદર\N_NN સ્વામીના\N_NN એક\QT_QTC શબ્દે\N_NN બોરડીએ\N_NN પોતાના\PR_PRI કાંટા\N_NN ખેરવી\V_VAUX_VNP નાખ્યા\V_VM હતા\V_VAUX .\RD_PUNC
GJRED426	વડોદરાની\N_NNP અંદર\N_NST સ્વામીના\N_NN વચને\N_NN ગ્રહણ\N_NN બદલાઈ\V_VM ગયું\V_VAUX .\RD_PUNC
GJRED427	વડોદરાની\N_NNP અંદર\N_NST પારસીનો\N_NN મૂંગો\JJ છોકરો\N_NN બોલતો\V_VAUX_VNP થઈ\V_VM ગયો\V_VAUX .\RD_PUNC
GJRED428	આવા\JJ અનેકાનેક\JJ પ્રસંગો\N_NN સ્વામીનારાયણ\N_NNP સંપ્રદાયના\N_NN ગ્રંથોમાં\N_NN સ્વામી\N_NN દ્વારા\PSP બનેલા\V_VAUX_VNP આશ્ચર્યોના\N_NN પુરાવા\N_NN રૂપે\N_NN આજે\N_NST ઝળહળી\V_VM રહ્યા\V_VAUX છે\V_VAUX .\RD_PUNC
GJRED429	સદગુરુ\N_NN શ્રી\N_NN ગોપાળાનંદ\N_NNP સ્વામીએ\N_NNP જીવનપર્યંત\JJ સત્સંગની\N_NN ખૂબ\QT_QTF જ\RP_RPD સેવા\N_NN કરી\V_VM છે\V_VAUX .\RD_PUNC
GJRED430	૨૨\QT_QTC વર્ષ\N_NN સુધી\PSP શ્રીજી\N_NNP મહારાજની\N_NNP સાથે\PSP રહી\V_VAUX_VNP સેવા\N_NN કરી\V_VM છે\V_VAUX .\RD_PUNC
GJRED431	શ્રી\N_NN સ્વામીનારાયણ\N_NNP ભગવાને\N_NNP નાની\JJ વયમાં\N_NN સંસારનો\N_NN ત્યાગ\N_NN કરીને\V_VAUX_VNP વનવિચરણનો\N_NN પ્રારંભ\N_NN કર્યો\V_VM હતો\V_VAUX .\RD_PUNC
GJRED432	સાત\QT_QTC વર્ષમાં\N_NN તેમણે\PR_PRP ૧૩૦૦૦\QT_QTC કી.મી.ની\N_NN પદયાત્રા\N_NN કરી\V_VM હતી\V_VAUX .\RD_PUNC
GJRED433	કેટકેટલાય\QT_QTF સંતો\N_NN મહંતોને\N_NN મળ્યા\V_VM હતા\V_VAUX .\RD_PUNC
GJRED434	કોઈ\DM_DMI આ\DM_DMD નીલકંઠવર્ણીને\JJ રોકીને\V_VAUX_VNP પોતાની\PR_PRF પાસે\PSP રાખી\V_VM શક્યા\V_VAUX ન\RP_NEG હતા\V_VAUX .\RD_PUNC
GJRED435	આ\DM_DMD મુક્તાનંદ\N_NNP સ્વામીને\N_NNP સ્વામીનારાયણ\N_NNP સંપ્રદાયમાં\N_NNP ``\RD_PUNC માનું\N_NN ``\RD_PUNC બિરુદ\N_NN આપવામાં\V_VAUX_VNP આવ્યું\V_VAUX છે\V_VAUX .\RD_PUNC
GJRED436	તેમની\PR_PRP વાણીમાં\N_NN એવી\JJ અજબ\JJ શક્તિ\N_NN હતી\V_VAUX કે\CC_CCS ,\RD_PUNC પત્થર\N_NN જેવો\JJ જીવ\N_NN હોય\V_VAUX તો\CC_CCD પણ\RP_RPD પીગળી\V_VM જાય\V_VAUX .\RD_PUNC
GJRED437	કંથકોટમાં\N_NNP આત્મહત્યા\N_NN કરવા\V_VAUX_VNP માટે\PSP ઝેર\N_NN ઘોળીને\V_VAUX_VNP પીવા\V_VAUX_VNP માટે\PSP તૈયાર\JJ થયેલી\V_VAUX_VNP બાઈ\N_NN એ\DM_DMD સત્સંગસભામાં\N_NN સ્વામીના\N_NN શબ્દો\N_NN સાંભળ્યા\V_VM અને\CC_CCD તેણે\PR_PRP આત્મહત્યા\N_NN કરવાનું\V_VAUX_VNP માંડી\V_VM વાળ્યું\V_VAUX .\RD_PUNC
GJRED438	અમદાવાદ\N_NNP શહેરમાં\N_NNP સત્સંગના\N_NN પાયા\N_NN પણ\RP_RPD તેમણે\PR_PRP જ\RP_RPD નાંખેલા\V_VAUX_VNP છે\V_VAUX .\RD_PUNC
GJRED439	વડોદરાની\N_NNP વિદ્વતસભામાં\N_NN વિજય\N_NN મેળવી\V_VAUX_VNP સ્વામીનારાયણ\N_NNP સંપ્રદાયનો\N_NNP વિશ્વમાં\N_NN વિજય\N_NN ધ્વજ\N_NN પણ\RP_RPD તેમણે\PR_PRP જ\RP_RPD લ્હેરાવ્યો\V_VM છે\V_VAUX .\RD_PUNC
GJRED440	સ્વામીનારાયણ\N_NNP સંપ્રદાયના\N_NNP સાહિત્ય\N_NN સર્જનમાં\N_NN સદ્\JJ શ્રીમુક્તાનંદ\N_NNP સ્વામીનો\N_NNP મહત્ત્વનો\JJ ફાળો\N_NN છે\V_VAUX .\RD_PUNC
GJRED441	શ્રીજીમહારાજે\N_NNP તેમને\PR_PRP આજ્ઞા\N_NN કરી\V_VM કે\CC_CCS ,\RD_PUNC તમે\PR_PRP જીવનપર્યંત\JJ સંપ્રદાયની\N_NN પુષ્ટિ\N_NN માટે\PSP શાસ્ત્રોની\N_NN રચના\N_NN કરજો\V_VM .\RD_PUNC
GJRED442	આ\DM_DMD આજ્ઞાને\N_NN શિરોવંદ્ય\JJ કરી\V_VM મુક્તાનંદસ્વામીએ\N_NNP અપાર\JJ સાહિત્યની\N_NN રચના\N_NN કરી\V_VM છે\V_VAUX .\RD_PUNC
GJRED443	સ્વામીની\N_NN કૃતિઓ\N_NN એટલે\PSP આજ્ઞાનો\N_NN અખૂટ\JJ ભંડાર\N_NN ,\RD_PUNC પ્રગટ\JJ આનંદના\N_NN આ\DM_DMD સ્વાદનું\N_NN કવિતારૂપી\JJ ધન\N_NN અને\CC_CCD મોક્ષ\N_NN પ્રાપ્તિનો\N_NN ઉન્નત\JJ માર્ગ\N_NN .\RD_PUNC
GJRED444	સદ્\JJ શ્રી\N_NN મુક્તાનંદ\N_NNP સ્વામીએ\N_NNP નાનાં\JJ -\RD_PUNC મોટાં\JJ ૩૨\QT_QTC શાસ્ત્રોનું\N_NN સર્જન\N_NN કર્યું\V_VM છે\V_VAUX .\RD_PUNC
GJRED445	જેમાં\PR_PRL સંસ્કૃત\N_NNP ભાષામાં\N_NNP ૫\QT_QTC ,\RD_PUNC હિન્દી\N_NNP ભાષામાં\N_NNP ૧૭\QT_QTC ,\RD_PUNC ગુજરાતી\N_NNP ભાષામાં\N_NNP ૮\QT_QTC અને\CC_CCD વ્રજ\N_NNP ભાષામાં\N_NNP ૨\QT_QTC છે\V_VAUX .\RD_PUNC
GJRED446	સાહિત્યનું\N_NN અખંડ\JJ સર્જન\N_NN કર્યું\V_VM છે\V_VAUX .\RD_PUNC
GJRED447	સમગ્ર\JJ સ્વામીનારાયણ\N_NNP સંપ્રદાયમાં\N_NNP સૌથી\JJ પંડિતાગ્રગણ્ય\JJ ,\RD_PUNC વિલક્ષણ\JJ વિભૂતિ\N_NN જો\CC_CCD કોઈ\PR_PRI હોય\V_VAUX તો\CC_CCD તે\DM_DMD સદ્\JJ શ્રી\N_NN નિત્યાનંદસ્વામી\N_NNP .\RD_PUNC
GJRED448	સ્વામિનારાયણ\N_NNP સંપ્રદાય\N_NNP સાથે\PSP જ્યારે\N_NST -\RD_PUNC જ્યારે\N_NST વિદ્વાનો\N_NN ચર્ચા\N_NN કરવા\V_VAUX_VNP માટે\PSP આવ્યા\V_VM છે\V_VAUX ત્યારે\N_NST -\RD_PUNC ત્યારે\N_NST અમદાવાદ\N_NNP ,\RD_PUNC જૂનાગઢ\N_NNP ,\RD_PUNC ઉમરેઠ\N_NNP આદિ\PSP શહેરોમાંથી\N_NN તેમનો\PR_PRP જો\CC_CCD કોઈએ\PR_PRI પરાભવ\N_NN કર્યો\V_VM હોય\V_VAUX તો\CC_CCD તે\DM_DMD કાર્યમાં\N_NN સદ્\JJ શ્રીનિત્યાનંદસ્વામી\N_NNP મોખરે\JJ છે\V_VAUX .\RD_PUNC
GJRED449	અરે\RP_INJ !\RD_PUNC અમદાવાદમાં\N_NNP તેમને\PR_PRP આવતા\V_VAUX_VNP જોઈને\V_VAUX_VNP જ\RP_RPD વિદ્વાનો\N_NN સભા\N_NN મોકૂફ\JJ રાખીને\V_VAUX_VNP પલાયન\JJ થઈ\V_VM ગયા\V_VAUX હતા\V_VAUX .\RD_PUNC
GJRED450	તેઓ\PR_PRP પ્રકાંડ\JJ પંડિત\N_NN હતા\V_VAUX .\RD_PUNC
GJRED451	ખુદ\PR_PRF શ્રી\N_NN સ્વામીનારાયણ\N_NNP ભગવાને\N_NNP તેમને\PR_PRP પ્રમાણપત્ર\N_NN આપેલું\V_VAUX_VNP હતું\V_VAUX કે\CC_CCS .\RD_PUNC
GJRED452	તેઓ\PR_PRP પ્રખર\JJ વિદ્વાન\N_NN તો\RP_RPD હતા\V_VAUX જ\RP_RPD પરંતુ\CC_CCD તેની\DM_DMD સાથે\PSP -\RD_PUNC સાથે\PSP શ્રી\N_NN સ્વામીનારાયણ\N_NNP ભગવાનના\N_NNP પરમ\JJ ઉપાસક\N_NN હતા\V_VAUX .\RD_PUNC
GJRED453	જ્યારે\N_NST સત્સંગીજીવન\N_NN ગ્રંથ\N_NN રચાતો\V_VAUX_VNP હતો\V_VAUX તે\DM_DMD સમયની\N_NN વાત\N_NN છે\V_VAUX .\RD_PUNC
GJRED454	ત્યારે\N_NST શ્રી\N_NN સ્વામિનારાયણ\N_NNP ભગવાનનું\N_NNP સ્વરૂપ\N_NN જેવું\JJ સર્વોપરી\JJ છે\V_VAUX તેવું\JJ જ\RP_RPD ગ્રંથોમાં\N_NN લખાવું\V_VAUX_VNP જોઈએ\V_VAUX તેના\DM_DMD માટે\PSP તેમણે\PR_PRP અનેક\JJ ઉપાધિ\N_NN સહન\JJ કરી\V_VM હતી\V_VAUX .\RD_PUNC
GJRED455	પરંતુ\CC_CCD આ\DM_DMD એક\QT_QTC નિત્યાનંદ\N_NNP સ્વામી\N_NNP ના\RP_NEG ફર્યા\V_VM .\RD_PUNC
GJRED456	ઉપાસક\N_NN તો\RP_RPD આવા\JJ જ\RP_RPD જોઈએ\V_VAUX .\RD_PUNC
GJRED457	શ્રી\N_NN હરિદિગ્વિજય\N_NNP અદભુત\JJ ગ્રંથ\N_NN તેમણે\PR_PRP સંસ્કૃતમાં\N_NNP રચ્યો\V_VM છે\V_VAUX .\RD_PUNC
GJRED458	તે\DM_DMD ગ્રંથનો\N_NN જો\CC_CCD અભ્યાસ\N_NN કરવામાં\V_VAUX_VNP આવે\V_VM તો\CC_CCD ખ્યાલ\N_NN આવે\V_VM કે\CC_CCS ,\RD_PUNC સ્વામી\N_NN કેવા\DM_DMQ વિચક્ષણ\JJ અને\CC_CCD વિદ્વાન\JJ હશે\V_VAUX ?\RD_PUNC
GJRED459	આ\DM_DMD ઉપરાંત\PSP તેમણે\PR_PRP દસથી\QT_QTC વધુ\QT_QTF ગ્રંથો\N_NN રચ્યા\V_VM છે\V_VAUX .\RD_PUNC
GJRED460	આવા\JJ વિદ્વાન\N_NN -\RD_PUNC મોટેરા\JJ સંત\N_NN હતા\V_VAUX .\RD_PUNC
GJRED461	તેમનું\PR_PRP શરીર\N_NN પણ\RP_RPD ખૂબ\QT_QTF જ\RP_RPD ભારે\JJ હતું\V_VAUX .\RD_PUNC
GJRED462	આમ\PSP ,\RD_PUNC સેવા\N_NN કરવામાં\V_VAUX_VNP તેઓ\PR_PRP એટલાં\JJ જ\RP_RPD નિરાભિમાની\JJ હતા\V_VAUX .\RD_PUNC
GJRED463	તેમના\PR_PRP સંપ્રદાયમાં\N_NN ભાર\N_NN પણ\RP_RPD બહુ\QT_QTF પડતો\V_VAUX_VNP હતો\V_VAUX .\RD_PUNC
GJRED464	નિયમ\N_NN -\RD_PUNC ધર્મની\N_NN બાબતમાં\N_NN તેઓ\PR_PRP ખૂબ\QT_QTF જ\RP_RPD કડક\JJ હતા\V_VAUX .\RD_PUNC
GJRED465	સંપ્રદાયમાં\N_NN નિત્ય\JJ કથાવાર્તા\N_NN -\RD_PUNC સમૈયા\N_NN ઉત્સવની\N_NN પ્રણાલિકા\N_NN પાડવામાં\V_VAUX_VNP પણ\RP_RPD તેમનો\PR_PRP મહત્તમ\JJ ફાળો\N_NN છે\V_VAUX .\RD_PUNC
GJRED466	ગુજરાત\N_NNP કદી\PSP કવિ\N_NN સૂનો\JJ રહ્યો\V_VM નથી\RP_NEG .\RD_PUNC
GJRED467	વનમોર\N_NN સૂનો\JJ હોય\V_VAUX તો\CC_CCD ગુજરાત\N_NNP કવિ\N_NN સૂનો\JJ હોય\V_VAUX .\RD_PUNC
GJRED468	સ્વામીનારાયણ\N_NNP સંપ્રદાયના\N_NNP આ\DM_DMD મહાન\JJ સંતોના\N_NN ,\RD_PUNC કવિઓનાં\N_NN કીર્તન\N_NN આજે\N_NST ૨૦૦\QT_QTC વર્ષ\N_NN પછી\PSP પણ\RP_RPD એવાં\JJ ને\CC_CCD એવાં\JJ જ\RP_RPD તાજગીભર્યા\JJ છે\V_VAUX .\RD_PUNC
GJRED469	સ્વામીનારાયણ\N_NNP સંપ્રદાયના\N_NNP કવિઓમાં\N_NN સદ્\N_NN શ્રી\N_NN બ્રહ્માનંદસ્વામીને\N_NNP સૂર્ય\N_NNP સમા\JJ તેજસ્વી\JJ મહાકવિ\N_NN તરીકે\PSP બિરદાવામાં\V_VAUX_VNP આવેલ\V_VAUX_VNP છે\V_VAUX .\RD_PUNC
GJRED470	૧૦,૦૦૦થી\QT_QTC વધુ\QT_QTF કીર્તનોની\N_NN તેમણે\PR_PRP રચના\N_NN કરી\V_VM છે\V_VAUX .\RD_PUNC
GJRED471	તેમને\PR_PRP સ્વામીનારાયણ\N_NNP સંપ્રદાયમાં\N_NNP શીઘ્ર\JJ કવિનું\N_NN બિરુદ\N_NN આપવામાં\V_VAUX_VNP આવેલ\V_VAUX_VNP છે\V_VAUX .\RD_PUNC
GJRED472	સદગુરુ\N_NN શ્રી\N_NN બ્રહ્માનંદ\N_NNP સ્વામીનું\N_NNP પ્રાગટ્ય\N_NN રાજસ્થાનમાં\N_NNP આવેલ\V_VAUX_VNP ખાણ\N_NNP ગામે\N_NNP સંવત્\N_NN ૧૮૨૮માં\QT_QTC થયું\V_VM હતું\V_VAUX .\RD_PUNC
GJRED473	તેમનું\PR_PRP પૂર્વાશ્રમનું\N_NN નામ\N_NN લાડુદાનજી\N_NNP હતું\V_VAUX .\RD_PUNC
GJRED474	તેમણે\PR_PRP નાની\JJ વયમાં\N_NN અભ્યાસ\N_NN કરી\V_VAUX_VNP રાજકવિરત્ન\N_NN ,\RD_PUNC મહામોહપાધ્યાય\N_NN ,\RD_PUNC પિંગળ\N_NN વિદ્યાચાર્ય\N_NN ,\RD_PUNC સહસ્નવધાની\N_NN જેવી\JJ પદવીઓ\N_NN પ્રાપ્ત\N_NN કરી\V_VM .\RD_PUNC
GJRED475	પરંતુ\CC_CCD આ\DM_DMD વિદ્યા\N_NN પ્રથમ\QT_QTO તો\RP_RPD તેમણે\PR_PRP રાજવીઓને\N_NN રાજી\JJ કરવા\V_VAUX_VNP માટે\PSP વાપરી\V_VM હતી\V_VAUX .\RD_PUNC
GJRED476	જામનગર\N_NNP ,\RD_PUNC ભાવનગર\N_NNP ,\RD_PUNC જૂનાગઢ\N_NNP અને\CC_CCD ગાયકવાડ\N_NNP સરકારે\N_NNP તેમને\PR_PRP મોટા\JJ -\RD_PUNC મોટા\JJ સરપાવો\N_NN આપી\V_VM નવાજ્યા\V_VM હતા\V_VAUX .\RD_PUNC
GJRED477	મીઠાની\N_NN પોટલી\N_NN સમુદ્રનો\N_NN તાગ\N_NN લેવા\V_VAUX_VNP ગઈ\V_VAUX અને\CC_CCD સમુદ્રમાં\N_NN જ\RP_RPD સમાઈ\V_VM ગઈ\V_VAUX .\RD_PUNC
GJRED478	તેમણે\PR_PRP શ્રી\N_NN સ્વામીનારાયણ\N_NNP ભગવાનના\N_NNP ચરણોમાં\N_NN મસ્તક\N_NN ઝુકાવી\V_VM દીધું\V_VAUX .\RD_PUNC
GJRED479	શ્રીજીમહારાજનું\N_NNP શરણું\N_NN સ્વીકાર્યા\V_VAUX_VNP પછી\PSP તો\RP_RPD તેમણે\PR_PRP સંપ્રદાયની\N_NN સાહિત્યક્ષેત્રે\N_NN અમૂલ્ય\JJ સેવા\N_NN કરી\V_VM છે\V_VAUX .\RD_PUNC
GJRED480	તેમણે\PR_PRP સંપ્રદાયમાં\N_NN કુલ\JJ ૧૮\QT_QTC જેટલા\JJ તો\RP_RPD ગ્રંથો\N_NN રચ્યા\V_VM છે\V_VAUX .\RD_PUNC
GJRED481	આમ\PSP ,\RD_PUNC સાહિત્ય\N_NN ક્ષેત્રે\N_NN તેમની\PR_PRP સેવા\N_NN અજોડ\JJ છે\V_VAUX .\RD_PUNC
GJRED482	બ્રહ્માનંદ\N_NNP સ્વામીએ\N_NNP ગુજરાતી\N_NNP ,\RD_PUNC હિંદી\N_NNP ,\RD_PUNC વ્રજ\N_NNP ,\RD_PUNC ચારણી\N_NNP ,\RD_PUNC કચ્છી\N_NNP ,\RD_PUNC રાજસ્થાની\N_NNP ભાષામાં\N_NN પણ\RP_RPD પદો\N_NN રચ્યાં\V_VM છે\V_VAUX .\RD_PUNC
GJRED483	વળી\PSP તેઓ\PR_PRP સરોદ\N_NN ,\RD_PUNC સિતાર\N_NN ,\RD_PUNC મૃદંગ\N_NN પણ\RP_RPD જ્યારે\N_NST વગાડતા\V_VAUX_VNP ત્યારે\N_NST સભા\N_NN સ્તબ્ધ\JJ થઈ\V_VM જતી\V_VAUX_VNP એવું\JJ એમનામાં\PR_PRP કૌશલ્ય\N_NN હતું\V_VAUX .\RD_PUNC
GJRED484	સ્વામીનારાયણ\N_NNP સંપ્રદાયના\N_NNP મંદિરની\N_NN રચના\N_NN કરવામાં\V_VAUX_VNP પણ\RP_RPD તેમણે\PR_PRP અગ્રિમ\JJ સેવા\N_NN આપી\V_VM છે\V_VAUX .\RD_PUNC
GJRED485	સ્વામીનારાયણ\N_NNP ભગવાનને\N_NNP વડતાલના\N_NNP મંદિરના\N_NN કાર્યનો\N_NN પ્રારંભ\N_NN કરવાનો\V_VAUX_VNP હતો\V_VAUX .\RD_PUNC
GJRED486	તેના\DM_DMD બદલામાં\N_NN ત્રણ\QT_QTC શિખરોવાળું\JJ કરવાનું\V_VAUX_VNP નક્કી\JJ કરીને\V_VAUX_VNP તે\DM_DMD દોરીને\V_VAUX_VNP શ્રીજીમહારાજને\N_NNP બતાવ્યું\V_VM .\RD_PUNC
GJRED487	આ\DM_DMD બ્રહ્માનંદસ્વામીને\N_NNP શ્રી\N_NN સ્વામીનારાયણ\N_NNP ભગવાને\N_NNP જેતલપુરના\N_NNP બીજા\JJ વચનામૃતમાં\N_NNP ``\RD_PUNC યતિ\N_NN ``\RD_PUNC પણાની\N_NN પ્રશંસા\N_NN કરી\V_VM છે\V_VAUX .\RD_PUNC
GJRED488	શુકાનંદ\N_NNP સ્વામી\N_NNP એટલે\PSP શ્રી\N_NN સ્વામીનારાયણ\N_NNP ભગવાનના\N_NNP હજુરી\JJ લહીયા\N_NN -\RD_PUNC લહીયા\N_NN -\RD_PUNC લેખક\N_NN .\RD_PUNC
GJRED489	તેમણે\PR_PRP સંસ્કૃતમાં\N_NNP ૭\QT_QTC અને\CC_CCD પ્રાકૃત\N_NNP ભાષામાં\N_NN ૯\QT_QTC જેટલા\JJ ગ્રંથો\N_NN તો\RP_RPD પોતે\PR_PRF જ\RP_RPD રચ્યા\V_VM છે\V_VAUX .\RD_PUNC
GJRED490	આવા\JJ વિદ્વાન\JJ લેખક\N_NN છતાં\RP_RPD અતિશય\JJ તેઓ\PR_PRP નિરાભિમાની\JJ હતા\V_VAUX .\RD_PUNC
GJRED491	સર્વે\JJ પ્રવૃત્તિ\N_NN તેમની\PR_PRP શ્રીજીને\N_NNP રાજી\N_NNP કરવા\V_VAUX_VNP માટેની\PSP હતી\V_VAUX .\RD_PUNC
GJRED492	ભગવાન\N_NN કેમ\DM_DMQ રાજી\JJ થાય\V_VM ?\RD_PUNC
GJRED493	એ\DM_DMD જ\RP_RPD એમનો\PR_PRP ઉદ્દેશ\N_NN હતો\V_VAUX .\RD_PUNC
GJRED494	સત્સંગીજીવન\N_NNP ગ્રંથ\N_NN જ્યારે\N_NST રચાયો\V_VM હતો\V_VAUX ત્યારે\N_NST શ્રીજીમહારાજે\N_NNP તે\DM_DMD ગ્રંથના\N_NN પાના\N_NN જોવા\V_VAUX_VNP માટે\PSP માંગ્યા\V_VM અને\CC_CCD ફાડી\V_VM નાંખ્યા\V_VAUX અને\CC_CCD ચાલ્યા\V_VM ગયા\V_VAUX .\RD_PUNC
GJRED495	કોઈ\PR_PRI સંતોએ\N_NN તેમને\PR_PRP પૂછ્યું\V_VM કે\CC_CCS ,\RD_PUNC સ્વામી\N_NN તમને\PR_PRP દુઃખ\N_NN ના\RP_NEG થયું\V_VM .\RD_PUNC
GJRED496	ત્યારે\N_NST સ્વામી\N_NN કહે\V_VM કે\CC_CCS ,\RD_PUNC હું\PR_PRP શ્રીજીને\N_NNP રાજી\JJ કરવા\V_VAUX_VNP લખું\V_VM છું\V_VAUX .\RD_PUNC
GJRED497	તે\PR_PRP ફાડીને\V_VAUX_VNP રાજી\JJ થાય\V_VM તો\CC_CCD ફાડીને\V_VAUX_VNP .\RD_PUNC
GJRED498	મારું\PR_PRP કામ\N_NN તો\RP_RPD તે\DM_DMD કહે\V_VM તેમ\PSP કરવાનું\V_VAUX_VNP છે\V_VAUX .\RD_PUNC
GJRED499	આવા\JJ વિદ્વાન\JJ -\RD_PUNC લેખક\N_NN છતાં\RP_RPD કેવો\DM_DMQ ધ્યેય\N_NN ?\RD_PUNC
GJRED500	કેવી\DM_DMQ સમજણ\N_NN ?\RD_PUNC
GJRED501	શુકાનંદસ્વામીની\N_NNP આત્માનિષ્ઠા\N_NN પણ\RP_RPD ટોચ\N_NN પર\PSP હતી\V_VAUX .\RD_PUNC
GJRED502	એક\QT_QTC દિવસ\N_NN તેઓ\PR_PRP બિમાર\JJ પડ્યા\V_VM .\RD_PUNC
GJRED503	તાવ\N_NN આવ્યો\V_VM હતો\V_VAUX .\RD_PUNC
GJRED504	શ્રીજીમહારાજે\N_NNP વાત\N_NN જાણી\V_VM કે\CC_CCS ,\RD_PUNC સાહિત્યની\N_NN રચના\N_NN કેમ\DM_DMQ અટકી\V_VM ગઈ\V_VAUX છે\V_VAUX ?\RD_PUNC
GJRED505	સાજો\JJ થઈશ\V_VM એટલે\PSP લખીશ\V_VM .\RD_PUNC
GJRED506	મહારાજે\N_NN તરત\PSP તેમને\PR_PRP સાજા\JJ કરી\V_VM દીધા\V_VAUX .\RD_PUNC
GJRED507	પછી\PSP તેમને\PR_PRP ક્યારેય\N_NST તાવ\N_NN આવ્યો\V_VM જ\RP_RPD નથી\RP_NEG .\RD_PUNC
GJRED508	શ્રીજીમહારાજ\N_NNP અંતર્ધાન\JJ થઈ\V_VM ગયા\V_VAUX .\RD_PUNC
GJRED509	પછી\PSP તેમણે\PR_PRP શ્રીજીને\N_NNP પ્રાર્થના\N_NN કરી\V_VM કે\CC_CCS ,\RD_PUNC મને\PR_PRP તાવ\N_NN આદિ\PSP દેહની\N_NN ઉપાધિ\N_NN કાંઈ\DM_DMI થતી\V_VAUX_VNP જ\RP_RPD નથી\RP_NEG .\RD_PUNC
GJRED510	તે\DM_DMD કૃપા\N_NN કરીને\V_VAUX_VNP આપો\V_VM ?\RD_PUNC
GJRED511	પછી\PSP મહારાજે\N_NN સંકલ્પ\N_NN કર્યો\V_VM .\RD_PUNC
GJRED512	એટલે\PSP તેમને\PR_PRP તાવ\N_NN આવ્યો\V_VM ત્યારે\N_NST સ્વામી\N_NN કહે\V_VM બહુ\QT_QTF દયા\N_NN કરી\V_VM .\RD_PUNC
GJRED513	અને\CC_CCD તે\DM_DMD તાવ\N_NN બાર\QT_QTC વર્ષ\N_NN સુધી\PSP રહ્યો\V_VM .\RD_PUNC
GJRED514	આમ\PSP ,\RD_PUNC તેઓ\PR_PRP સામેથી\PSP દુઃખ\N_NN માંગીને\V_VAUX_VNP જીવન\N_NN જીવતા\V_VAUX_VNP .\RD_PUNC
GJRED515	શુકમુનિ\N_NNP બહુ\QT_QTF મોટા\JJ સાધુ\N_NN છે\V_VAUX ને\CC_CCD જે\PR_PRL દિવસથી\N_NN અમારી\PR_PRP પાસે\PSP રહ્યા\V_VM છે\V_VAUX તે\PR_PRL દિવસથી\N_NN એમનો\PR_PRP ચડતો\V_VAUX_VNP ને\CC_CCD ચડતો\V_VAUX_VNP રંગ\N_NN છે\V_VAUX ,\RD_PUNC પણ\CC_CCD મંદ\JJ પડતો\V_VAUX_VNP નથી\RP_NEG .\RD_PUNC
GJRED516	એ\DM_DMD તો\RP_RPD મુક્તાનંદ\N_NNP સ્વામી\N_NN જેવા\JJ છે\V_VAUX .\RD_PUNC
GJRED517	શુકાનંદ\N_NNP સ્વામી\N_NNP મૂળ\JJ ડભાણના\N_NNP હતા\V_VAUX .\RD_PUNC
GJRED518	વૈરાગ્યની\N_NN અગ્નિથી\N_NN સદાય\JJ તેજોમય\JJ અને\CC_CCD છતાં\RP_RPD ભક્તિના\N_NN શીતળ\JJ સાગરમાં\N_NN વિહાર\N_NN કરતાં\V_VAUX_VNP સંત\N_NN એટલે\PSP નિષ્કુળાનંદસ્વામી\N_NNP .\RD_PUNC
GJRED519	સદગુરુ\N_NN શ્રી\N_NN નિષ્કુળાનંદ\N_NNP સ્વામી\N_NN માત્ર\RP_RPD સ્વામિનારાયણ\N_NNP સંપ્રદાયના\N_NNP નહીં\RP_NEG ,\RD_PUNC ગરવી\JJ ગુજરાતના\N_NNP એક\QT_QTC પનોતા\JJ સંત\N_NN કવિ\N_NN છે\V_VAUX .\RD_PUNC
GJRED520	મહાત્મા\N_NNP ગાંધીજી\N_NNP સુધી\PSP સૌ\JJ કોઈને\PR_PRI પોતાના\PR_PRF સ્વરચિત\JJ ભક્તિસભર\JJ પદોથી\N_NN તેમણે\PR_PRP મોહિત\JJ કર્યા\V_VM છે\V_VAUX .\RD_PUNC
GJRED521	મહાત્મા\N_NNP ગાંધીજીએ\N_NNP પણ\RP_RPD પોતાના\PR_PRF આશ્રમમાં\N_NN જે\PR_PRL પદો\N_NN નિત્ય\JJ ગાવાની\V_VAUX_VNP આજ્ઞા\N_NN કરી\V_VM હતી\V_VAUX .\RD_PUNC
GJRED522	તેમાંનું\DM_DMD એક\QT_QTC નિષ્કુળાનંદસ્વામી\N_NNP રચિત\JJ પદ\N_NN હતું\V_VAUX .\RD_PUNC
GJRED523	``\RD_PUNC ત્યાગ\N_NN ન\RP_NEG ટકે\V_VM રે\N_NN વૈરાગ્ય\N_NN વિના\PSP .\RD_PUNC ``\RD_PUNC
GJRED524	એ\DM_DMD સુપ્રસિદ્ધ\JJ ભજનો\N_NN જે\PR_PRL કોઈ\PR_PRI સાંભળે\V_VM છે\V_VAUX તો\CC_CCD તેના\PR_PRP હૃદયમાંથી\N_NN આજે\N_NST ય\RP_RPD સંસારના\N_NN વિષ\N_NN ઊતરી\V_VM જાય\V_VAUX છે\V_VAUX .\RD_PUNC
GJRED525	વૈરાગ્યની\N_NN ભાવના\N_NN પ્રજવલિત\JJ થાય\V_VM છે\V_VAUX .\RD_PUNC
GJRED526	શિલ્પકળામાં\N_NN પણ\RP_RPD આજે\N_NST ય\RP_RPD ધોલેરા\N_NNP -\RD_PUNC મૂળી\N_NNP મંદિરમાં\N_NNP ઘડેલી\V_VAUX_VNP કમાનો\N_NN પુરાવો\N_NN આપે\V_VM છે\V_VAUX .\RD_PUNC
GJRED527	શ્રી\N_NN હરિની\N_NNP પ્રસન્નતા\N_NN પ્રાપ્ત\JJ કરવા\V_VAUX_VNP માટે\PSP તેઓ\PR_PRP સંસારનો\N_NN ત્યાગ\N_NN કરવા\V_VAUX_VNP માટે\PSP તૈયાર\JJ થયા\V_VM .\RD_PUNC
GJRED528	તો\CC_CCD પણ\RP_RPD તે\PR_PRP અગ્નિપરીક્ષામાંથી\N_NN પાસ\JJ થયા\V_VM હતા\V_VAUX .\RD_PUNC
GJRED529	અને\CC_CCD શ્રી\N_NN હરિએ\N_NNP તેમનું\PR_PRP લાલજી\N_NNP સુતારમાંથી\N_NNP નિષ્કુળાનંદસ્વામી\N_NNP નામ\N_NN પાડ્યું\V_VM હતું\V_VAUX .\RD_PUNC
GJRED530	નિષ્કુળાનંદ\N_NNP સ્વામીની\N_NNP કલમ\N_NN ચાલી\V_VM ને\CC_CCD સ્વામીનારાયણ\N_NNP સંપ્રદાયના\N_NNP સાહિત્યના\N_NN સર્જનનો\N_NN પ્રારંભ\N_NN થયો\V_VM .\RD_PUNC
GJRED531	આધોઈમાં\N_NNP એક\QT_QTC વખત\N_NN નિષ્કુળાનંદસ્વામી\N_NNP પધાર્યા\V_VM .\RD_PUNC
GJRED532	આવી\JJ તેમનામાં\PR_PRP અદભુત\JJ શક્તિ\N_NN હતી\V_VAUX .\RD_PUNC
GJRED533	તેઓ\PR_PRP બીજા\JJ કવિઓ\N_NN કે\CC_CCS લેખકોની\N_NN જેમ\PSP માત્ર\RP_RPD લખતા\V_VAUX_VNP હતા\V_VAUX .\RD_PUNC
GJRED534	સ્વામીનારાયણ\N_NNP સંપ્રદાયમાં\N_NNP આ\DM_DMD રીતે\N_NN સદ્\JJ શ્રી\N_NN નિષ્કુળાનંદ\N_NNP સ્વામીએ\N_NNP ૪૧\QT_QTC વર્ષ\N_NN સુધી\PSP સાહિત્ય\N_NN ક્ષેત્રે\N_NN ,\RD_PUNC સંગીત\N_NN ક્ષેત્રે\N_NN ,\RD_PUNC મંદિરના\N_NN નિર્માણ\N_NN કાર્યમાં\N_NN અમૂલ્ય\JJ સેવા\N_NN આપી\V_VM છે\V_VAUX .\RD_PUNC
GJRED535	તેઓ\PR_PRP નિયમ\N_NN ધર્મ\N_NN પાળવામાં\V_VAUX_VNP મેરુ\N_NNP સમાન\JJ હતા\V_VAUX .\RD_PUNC
GJRED536	વૈરાગ્યમાં\N_NN શિખર\N_NN સમાન\JJ અને\CC_CCD સાદગીમાં\N_NN અજોડ\JJ હતા\V_VAUX .\RD_PUNC
GJRED537	આ\DM_DMD સંત\N_NN પૃથ્વી\N_NN ઉપર\PSP મનુષ્ય\N_NN સ્વરૂપે\N_NN રહ્યા\V_VM ત્યાં\N_NST સુધી\PSP નિત્ય\JJ રોટલો\N_NN ને\CC_CCD છાશ\N_NN જ\RP_RPD જમ્યા\V_VM છે\V_VAUX .\RD_PUNC
GJRED538	સ્વામીનારાયણ\N_NNP સંપ્રદાયમાં\N_NNP અનેક\JJ કવિ\N_NN સંતો\N_NN થયા\V_VM છે\V_VAUX .\RD_PUNC
GJRED539	આ\DM_DMD કવિ\N_NN સંતોમાં\N_NN ય\RP_RPD અષ્ટ\JJ કવિઓ\N_NN મુખ્ય\JJ છે\V_VAUX .\RD_PUNC
GJRED540	પ્રેમાનંદ\N_NNP સ્વામીને\N_NNP ચંદ્રમા\N_NN તરીકેની\PSP ઉપમા\N_NN આપવામાં\V_VAUX_VNP આવી\V_VAUX છે\V_VAUX .\RD_PUNC
GJRED541	બ્રહ્મ\N_NNP મુનિ\N_NNP કવિ\N_NN ભાનુ\N_NNP જેવા\JJ છે\V_VAUX .\RD_PUNC
GJRED542	આ\DM_DMD પ્રેમાનંદ\N_NNP સ્વામીએ\N_NNP ભગવાનની\N_NN મૂર્તિના\N_NN અદભુત\JJ કીર્તનોની\N_NN પદોની\N_NN રચના\N_NN કરી\V_VM છે\V_VAUX .\RD_PUNC
GJRED543	જેણે\PR_PRL આવી\JJ રીતે\N_NN ભગવાનની\N_NN મૂર્તિનું\N_NN ચિંતવન\N_NN રહેતું\V_VAUX_VNP હોય\V_VAUX તેવા\JJ સંતને\N_NN તો\RP_RPD ઉઠીને\V_VAUX_VNP સાષ્ટાંગ\JJ દંડવત્\JJ પ્રણામ\N_NN કરીએ\V_VM .\RD_PUNC
GJRED544	આજે\N_NST ય\RP_RPD સમગ્ર\JJ સ્વામીનારાયણ\N_NNP સંપ્રદાયના\N_NNP મંદિરો\N_NN અને\CC_CCD સત્સંગીઓના\N_NN ઘરે\N_NN નિત્ય\JJ આ\DM_DMD પદ\N_NN ગવાય\V_VM છે\V_VAUX .\RD_PUNC
GJRED545	આ\DM_DMD ઉપરાંત\PSP તેમના\PR_PRP આ.....જ\N_NST મારે\PR_PRP ઓરડેના\N_NN ચાર\QT_QTC પદ\N_NN પણ\RP_RPD ખૂબ\QT_QTF પ્રસિદ્ધ\JJ છે\V_VAUX .\RD_PUNC
GJRED546	આ\DM_DMD પ્રેમાનંદ\N_NNP સ્વામી\N_NNP ગાવામાં\V_VAUX_VNP પ્રવીણ\JJ હતા\V_VAUX .\RD_PUNC
GJRED547	આવું\JJ સંગીત\N_NN મેં\PR_PRP ક્યારેય\N_NST સાંભળ્યું\V_VM નથી\RP_NEG .\RD_PUNC
GJRED548	એવા\JJ તે\PR_PRP સ્વામી\N_NN ઉપર\PSP આફરીન\JJ થઈ\V_VM ગયા\V_VAUX હતા\V_VAUX .\RD_PUNC
GJRED549	આ\DM_DMD પ્રેમાનંદસ્વામીએ\N_NNP કેટલા\QT_QTF કીર્તન\N_NN રચ્યાં\V_VM છે\V_VAUX તે\DM_DMD હજુ\N_NST સુધી\PSP કોઈ\PR_PRI શોધી\V_VM શક્યું\V_VAUX નથી\RP_NEG .\RD_PUNC
GJRED550	પરંતુ\CC_CCD ચારેક\QT_QTC હજાર\N_NN કીર્તનો\N_NN પ્રસિદ્ધ\JJ થયા\V_VM છે\V_VAUX .\RD_PUNC
GJRED551	તેમ\PSP માનવામાં\V_VAUX_VNP આવે\V_VAUX છે\V_VAUX .\RD_PUNC
GJRED552	શ્રી\N_NN સ્વામીનારાયણ\N_NNP ભગવાનનો\N_NNP તેમણે\PR_PRP અત્યંત\JJ રાજીપો\N_NN પ્રાપ્ત\JJ કર્યો\V_VM હતો\V_VAUX .\RD_PUNC
GJRED553	તેમને\PR_PRP ભગવાન\N_NN પોતાનો\PR_PRF પ્રસાદીનો\N_NN થાળ\N_NN નિત્ય\JJ આપતા\V_VAUX_VNP .\RD_PUNC
GJRED554	અનેક\JJ જીવોના\N_NN ઉદ્ધારાર્થે\N_NN અમારી\PR_PRP ઈચ્છાથી\N_NN આ\DM_DMD નિર્ગુણદાસજી\N_NNP સ્વામી\N_NNP અમારી\PR_PRP મૂર્તિમાં\N_NN રહીને\V_VAUX_VNP આ\DM_DMD પૃથ્વી\N_NNP લોકોમાં\N_NN દેખાય\V_VM છે\V_VAUX .\RD_PUNC
GJRED555	એમને\PR_PRP તમે\PR_PRP તમારા\PR_PRP દેશમાંથી\N_NN જવા\V_VAUX_VNP દેશો\V_VM નહીં\RP_NEG અને\CC_CCD જવા\V_VAUX_VNP દેશો\V_VM તો\CC_CCD ,\RD_PUNC એ\DM_DMD તો\RP_RPD તમારે\PR_PRP ઘરેણારૂપ\N_NN છે\V_VAUX .\RD_PUNC
GJRED556	તે\DM_DMD તમારું\PR_PRP ભૂષણ\N_NN જતું\V_VAUX_VNP રહેશે\V_VAUX .\RD_PUNC
GJRED557	આવા\JJ તે\PR_PRP સમર્થ\JJ સંત\N_NN હતા\V_VAUX .\RD_PUNC
GJRED558	તેઓ\PR_PRP વચન\N_NN સિદ્ધ\JJ પણ\RP_RPD હતા\V_VAUX .\RD_PUNC
GJRED559	તેઓ\PR_PRP ભૂત\N_NN -\RD_PUNC ભવિષ્યનું\N_NN જાણતા\V_VAUX_VNP હતા\V_VAUX .\RD_PUNC
GJRED560	તેમનો\PR_PRP સમાગમ\N_NN કરવા\V_VAUX_VNP માટે\PSP આખો\JJ દિવસ\N_NN તેમની\PR_PRP પાસે\PSP સંતો\N_NN -\RD_PUNC ભક્તો\N_NN અખંડ\JJ બેસી\V_VM જ\RP_RPD રહેતા\V_VAUX_VNP હતા\V_VAUX .\RD_PUNC
GJRED561	શ્રી\N_NN સ્વામીનારાયણ\N_NNP ભગવાનના\N_NNP અક્ષરધામમાં\N_NNP સંકલ્પ\N_NN માત્રમાં\RP_RPD મૂકી\V_VM દેવાનું\V_VAUX_VNP તેમનામાં\DM_DMD સામર્થ્ય\N_NN હતું\V_VAUX .\RD_PUNC
GJRED562	મુખમાં\N_NN સ્વામીનારાયણ\N_NNP મંત્રનો\N_NN નાદ\N_NN ગુંજતો\V_VAUX_VNP કરી\V_VM દેવો\V_VAUX_VNP એ\DM_DMD એમના\PR_PRP માટે\PSP સહજ\JJ હતું\V_VAUX .\RD_PUNC
GJRED563	સત્સંગીની\N_NN ઘણી\QT_QTF સેવા\N_NN કરીને\V_VAUX_VNP શ્રી\N_NN સ્વામીનારાયણ\N_NNP ભગવાનના\N_NNP અદ્વિતીય\JJ સુખમાં\N_NN અનેકને\JJ જોડ્યા\V_VM છે\V_VAUX .\RD_PUNC
GJRED564	આ\DM_DMD ભગીરથ\JJ કાર્ય\N_NN કરતાં\V_VAUX_VNP અને\CC_CCD દુઃખો\N_NN પણ\RP_RPD હસતાં\V_VAUX_VNP મુખે\N_NN તેમણે\PR_PRP સહ્યા\V_VM છે\V_VAUX .\RD_PUNC
GJRED565	અનેકને\JJ સંસારનાં\N_NN બંધનમાંથી\N_NN છોડાવવાનું\V_VAUX_VNP સર્વોત્તમ\JJ કાર્ય\N_NN તેઓ\PR_PRP કરતાં\V_VAUX_VNP હતા\V_VAUX .\RD_PUNC
GJRED566	છતાં\RP_RPD અજ્ઞાની\JJ જીવો\N_NN તેમને\PR_PRP વાસામાં\N_NN અનંત\JJ લાકડીઓનો\N_NN માર\N_NN મારી\V_VM જતાં\V_VAUX_VNP છતાં\RP_RPD તેઓએ\PR_PRP સૌને\JJ ક્ષમા\N_NN અર્પી\V_VM છે\V_VAUX .\RD_PUNC
GJRED567	અને\DM_DMD ભગવાનના\N_NN શરણમાં\N_NN જ\RP_RPD જોડવાનું\V_VAUX_VNP જ\RP_RPD કાર્ય\N_NN કર્યું\V_VM છે\V_VAUX .\RD_PUNC
GJRED568	સંતોની\N_NN આવી\JJ ક્ષમા\N_NN ભાવનાને\N_NN કારણે\PSP જ\RP_RPD આજે\N_NST સ્વામીનારાયણ\N_NNP સંપ્રદાયની\N_NNP જ્યોતિ\N_NN ઝળહળે\V_VM છે\V_VAUX .\RD_PUNC
GJRED569	સારાય\JJ વિશ્વમાં\N_NN મંદિરોના\N_NN શિખરો\N_NN ઉપર\PSP ધ્વજા\N_NN ફરકે\V_VM છે\V_VAUX અને\CC_CCD દેશ\N_NN વિદેશમાં\N_NN સ્વામીનારાયણના\N_NN નાદ\N_NN ગૂંજે\V_VM છે\V_VAUX .\RD_PUNC
GJRED570	અબજીબાપા\N_NNP જેઓ\PR_PRP શ્રી\N_NN સ્વામીનારાયણ\N_NNP ભગવાનના\N_NNP ગૂઢ\JJ તત્વજ્ઞાનના\N_NN રહસ્યોને\N_NN સુગમ\JJ કરીને\V_VAUX_VNP સમજાવતા\V_VAUX_VNP હતા\V_VAUX .\RD_PUNC
GJRED571	તેમની\PR_PRP સાથે\PSP રહીને\V_VAUX_VNP તે\PR_PRP અમૃતવાણીને\N_NN સદ્\JJ શ્રી\N_NN ઈશ્વરચરણદાસજી\N_NNP સ્વામીએ\N_NNP ગ્રંથસ્થ\JJ કરી\V_VM ૧૮\QT_QTC -\RD_PUNC ૧૮\QT_QTC વર્ષ\N_NN દાખડો\N_NN કર્યો\V_VM .\RD_PUNC
GJRED572	દેદીપ્યમાન\JJ દિવ્ય\JJ વ્યક્તિત્વ\N_NN .\RD_PUNC
GJRED573	અમૃતધારા\N_NN સમાન\JJ વાણી\N_NN પ્રવાહ\N_NN ,\RD_PUNC નિર્વ્યાજ\JJ પ્રેમ\N_NN .\RD_PUNC
GJRED574	ચુસ્ત\JJ નિયમ\N_NN પાલન\N_NN .\RD_PUNC
GJRED575	વિપુલ\JJ શાસ્ત્રજ્ઞાનથી\N_NN ઓપતી\V_VAUX_VNP આકર્ષક\JJ મૂર્તિને\N_NN બસ\PSP નિહાળ્યા\V_VM જ\RP_RPD કરીએ\V_VM ,\RD_PUNC નિહાળ્યા\V_VM જ\RP_RPD કરીએ\V_VM .\RD_PUNC
GJRED576	સદગુરુ\N_NN શ્રી\N_NN ઈશ્વરચરણદાસજી\N_NNP સ્વામીએ\N_NNP તેમને\PR_PRP સંતની\N_NN દીક્ષા\N_NN આપીને\V_VAUX_VNP અનેક\JJ જીવોને\N_NN મુક્ત\JJ કરવા\V_VAUX_VNP માટે\PSP જ\RP_RPD તેમનું\PR_PRP પ્રાગટ્ય\N_NN થયું\V_VM .\RD_PUNC
GJRED577	ગામ\N_NN અને\CC_CCD શહેરો\N_NN શહેર\N_NN વિચરણ\N_NN કર્યું\V_VM છે\V_VAUX ને\CC_CCD અહેલક\N_NN વગાડી\V_VM છે\V_VAUX .\RD_PUNC
GJRED578	જેમ\PSP સ્વામી\N_NN વિવેકાનંદજીએ\N_NNP અમેરિકાના\N_NNP શિકાગોમાં\N_NNP સૌ\JJ પ્રથમ\QT_QTO સભા\N_NN સંબોધીને\V_VAUX_VNP ભારતીય\JJ સંસ્કૃતિનો\N_NN જય\N_NN જયકાર\N_NN કર્યો\V_VM હતો\V_VAUX .\RD_PUNC
GJRED579	તેમ\PSP મુક્તજીવન\N_NNP સ્વામીબાપાએ\N_NNP લંડનના\N_NNP ટ્રફાલ્ગર\N_NNP સ્કેવર\N_NNP ઉપર\PSP ૧૭\N_NNP -\RD_PUNC ૧૦\N_NNP -\RD_PUNC ૧૯૭૦ના\N_NNP દિને\N_NST અંગ્રેજીમાં\N_NNP પ્રવચન\N_NN આપી\V_VAUX_VNP હિન્દુ\N_NNP ધર્મનો\N_NNP વિજય\N_NN ધ્વજ\N_NN લહેરાવ્યો\V_VM છે\V_VAUX .\RD_PUNC
GJRED580	આરબ\N_NNP દેશોમાં\N_NNP પણ\RP_RPD અબુધાબી\N_NNP વગેરે\PSP જગ્યાએ\N_NN પણ\RP_RPD વિજય\N_NN ધ્વજ\N_NN લહેરાવ્યો\V_VM .\RD_PUNC
GJRED581	શારજહા\N_NNP આદિ\PSP વિવિધ\JJ સ્થળોએ\N_NN પણ\RP_RPD વિચરણ\N_NN કરી\V_VAUX_VNP પ્રજાને\N_NN સંબોધી\V_VM છે\V_VAUX .\RD_PUNC
GJRED582	તેથી\PSP જ\RP_RPD દરેક\JJ સંતો\N_NN -\RD_PUNC મહંતો\N_NN કહેતા\V_VAUX_VNP શ્રી\N_NN મુક્તજીવનદાસજી\N_NNP સ્વામી\N_NNP ભારતના\N_NNP સકલ\JJ સાધુ\N_NN સમાજમાં\N_NN અનુપમ\JJ રત્ન\N_NN છે\V_VAUX .\RD_PUNC
GJRED583	સ્વામિનારાયણ\N_NNP સંપ્રદાયમાં\N_NNP શૈક્ષણિક\JJ ક્ષેત્રે\N_NN અને\CC_CCD સામાજીક\JJ ક્ષેત્રે\N_NN સૌ\JJ પ્રથમ\QT_QTO કદમ\N_NN ઊઠાવી\V_VM મુક્તજીવન\N_NNP સ્વામીબાપાએ\N_NNP સ્વામીનારાયણ\N_NNP કૉલેજ\N_NNP -\RD_PUNC હાઈસ્કુલ\N_NNP ,\RD_PUNC છાત્રાલય\N_NNP હૉસ્પિટલ\N_NNP આદિ\PSP સ્થાયી\JJ જનસમાજની\N_NN સેવા\N_NN કરવાનો\V_VAUX_VNP રાહ\N_NN ચીંધ્યો\V_VM .\RD_PUNC
GJRED584	સ્વામીનારાયણ\N_NNP સંપ્રદાયના\N_NNP મંદિરોમાં\N_NN જીવનપ્રાણ\N_NNP બાપાશ્રીની\N_NNP મૂર્તિઓ\N_NN પધરાવી\V_VM .\RD_PUNC
GJRED585	સ્વામીનારાયણ\N_NNP સંપ્રદાયમાં\N_NNP ઘનશ્યામ\N_NNP મહારાજની\N_NNP મધ્યસ્થ\JJ ખંડમાં\N_NN મૂર્તિ\N_NN પધરાવી\V_VAUX_VNP સર્વોપરી\JJ ઉપાસનાની\N_NN પહેલ\N_NN પણ\RP_RPD તેમણે\PR_PRP જ\RP_RPD પાડી\V_VM છે\V_VAUX .\RD_PUNC
GJRED586	સ્વામિનારાયણ\N_NNP સંપ્રદાયમાં\N_NNP સદ્\JJ શ્રી\N_NN ઈશ્વરચરણદાસજી\N_NNP સ્વામી\N_NNP અને\CC_CCD શ્રીજી\N_NNP સંકલ્પ\N_NNP મૂર્તિ\N_NNP જીવનપ્રાણ\N_NNP બાપાશ્રીએ\N_NN સંપ્રદાયમાં\N_NN દેવની\N_NN મિલ્કત\N_NN દેવની\N_NN જ\RP_RPD રહે\V_VM તે\DM_DMD માટે\PSP મહાસભાની\N_NN સ્થાપના\N_NN કરી\V_VM હતી\V_VAUX .\RD_PUNC
GJRED587	આ\DM_DMD બધા\QT_QTF સિદ્ધાંતો\N_NN અને\CC_CCD મહાસભાની\N_NN સ્થાપના\N_NN પાછળના\PSP હેતુઓ\N_NN ઉપર\PSP જતે\N_NN દહાડે\N_NN પાણી\N_NN ફરી\V_VM વળશે\V_VAUX એવો\JJ તેમને\PR_PRP ભય\N_NN હતો\V_VAUX .\RD_PUNC
GJRED588	તેથી\PSP તેમણે\PR_PRP શ્રી\N_NN મુક્તજીવન\N_NNP સ્વામીબાપાને\N_NNP આજ્ઞા\N_NN કરી\V_VM કે\CC_CCS ,\RD_PUNC હાલ\N_NST તો\RP_RPD અમો\PR_PRP છીએ\V_VAUX એટલે\PSP મહાસભાના\N_NN ૮૦\QT_QTC જેટલા\JJ સાધુઓ\N_NN છે\V_VAUX .\RD_PUNC
GJRED589	ગુરુવર્યની\N_NN આજ્ઞા\N_NN થતાં\V_VAUX_VNP જ\RP_RPD જીવનપ્રાણ\N_NNP સ્વામીબાપાએ\N_NNP શાસ્ત્રી\N_NN શ્રી\N_NN આનંદપ્રિયદાસજી\N_NNP સ્વામીને\N_NNP ત્યાગની\N_NN દીક્ષા\N_NN આપી\V_VM .\RD_PUNC
GJRED590	આવા\JJ વિશ્વાસને\N_NN પાત્ર\JJ રૂપ\N_NN તે\DM_DMD સંત\N_NN છે\V_VAUX .\RD_PUNC
GJRED591	સ્વામિનારાયણ\N_NNP સંપ્રદાયના\N_NNP સંતોમાંથી\N_NN સૌ\JJ પ્રથમ\QT_QTO વિદેશની\N_NN ભૂમિ\N_NN ઉપર\PSP પગ\N_NN મૂકનાર\V_VAUX_VNP શ્રી\N_NN મુક્તજીવન\N_NNP સ્વામીબાપાની\N_NNP સાથે\PSP કોઈ\PR_PRI સંત\N_NN હોય\V_VAUX તો\CC_CCD તે\PR_PRI શ્રી\N_NN આનંદ\N_NNP પ્રિયદાસજીસ્વામી\N_NNP જીવનપ્રાણ\N_NNP અબજીબાપાશ્રીના\N_NNP પણ\RP_RPD જેઓએ\PR_PRL દર્શન\N_NN -\RD_PUNC સ્પર્શનું\N_NN સુખ\N_NN માણેલું\V_VAUX_VNP છે\V_VAUX .\RD_PUNC
GJRED592	ત્યાગી\JJ -\RD_PUNC સાધુ\N_NN સંતો\N_NN જ\RP_RPD સમાજને\N_NN અનુકરણરૂપ\N_NN છે\V_VAUX .\RD_PUNC
GJRED593	તેઓ\PR_PRP જ\RP_RPD સમાજના\N_NN પોષક\JJ છે\V_VAUX .\RD_PUNC
GJRED594	તેથી\PSP તેઓ\PR_PRP નિયમ\N_NN -\RD_PUNC ધર્મમાં\N_NN ન\RP_NEG વર્તે\V_VM તે\DM_DMD ચલાવી\V_VM ના\RP_NEG લેવાય\V_VM .\RD_PUNC
GJRED595	શાસ્ત્રો\N_NN અને\CC_CCD અનેક\JJ સાધનાઓમાં\N_NN જંગલમાં\N_NN ભૂલા\JJ પડેલા\V_VAUX_VNP માનવીને\N_NN આત્યંતિક\JJ મોક્ષની\N_NN વાટ\N_NN બતાવી\V_VAUX_VNP શ્રી\N_NN સ્વામીનારાયણ\N_NNP ભગવાનના\N_NNP શાશ્વત\JJ સુખમાં\N_NN જોડવાના\V_VAUX_VNP ભગીરથ\JJ કાર્યને\N_NN જ\RP_RPD જેમણે\PR_PRP પોતાનો\PR_PRF જીવનમંત્ર\N_NN બનાવ્યો\V_VM છે\V_VAUX .\RD_PUNC
GJRED596	અનેક\JJ પરિવારોની\N_NN નિરાશાઓ\N_NN દૂર\JJ થઈ\V_VM છે\V_VAUX .\RD_PUNC
GJRED597	પરિવારમાં\N_NN સ્નેહ\N_NN -\RD_PUNC સંપના\N_NN દીપક\N_NN પ્રગટ્યા\V_VM છે\V_VAUX .\RD_PUNC
GJRED598	અનેક\JJ યુવાનોમાં\N_NN સેવાના\N_NN ધબકાર\N_NN ઊઠ્યા\V_VM છે\V_VAUX .\RD_PUNC
GJRED599	વિદેશમાં\N_NN પણ\RP_RPD જને\N_NN -\RD_PUNC જને\N_NN સત્સંગના\N_NN તેજરશ્મિ\N_NN ફેલાયાં\V_VM છે\V_VAUX .\RD_PUNC
GJRED600	ઘાટ\N_NN -\RD_PUNC સંકલ્પો\N_NN શમી\V_VM જાય\V_VAUX છે\V_VAUX .\RD_PUNC
GJRED601	મનમાં\N_NN મૂંઝવતા\V_VAUX_VNP પ્રશ્નોના\N_NN ઊકેલ\N_NN મળી\V_VM જાય\V_VAUX છે\V_VAUX .\RD_PUNC
GJRED602	દિવ્યતાનો\N_NN અનુભવ\N_NN થાય\V_VM છે\V_VAUX .\RD_PUNC
GJRED603	ભક્તિ\N_NN ખીલી\V_VM ઊઠે\V_VAUX છે\V_VAUX .\RD_PUNC
GJRED604	સાહિત્ય\N_NN ક્ષેત્રે\N_NN તેમણે\PR_PRP `\RD_PUNC શ્રી\N_NN અબજીબાપા\N_NNP ચરિત્રામૃત\N_NNP સાગર\N_NNP `\RD_PUNC ,\RD_PUNC `\RD_PUNC સત્સંગ\N_NNP સુધારસ\N_NNP `\RD_PUNC ,\RD_PUNC `\RD_PUNC હૈયાનાં\N_NNP હસ્તાક્ષર\N_NNP `\RD_PUNC ,\RD_PUNC `\RD_PUNC શ્રીહરિની\N_NNP સર્વોપરીતા\N_NNP `\RD_PUNC જેવા\JJ ગ્રંથો\N_NN રચીને\V_VAUX_VNP તેમણે\PR_PRP માનવીના\N_NN નૈતિક\JJ મૂલ્યો\N_NN અને\CC_CCD માનવ\N_NN જીવનના\N_NN ધ્યેય\N_NN ઉપર\PSP પ્રકાશ\N_NN પાથર્યો\V_VM છે\V_VAUX .\RD_PUNC
GJRED605	સ્વામીનારાયણ\N_NNP સંપ્રદાયને\N_NNP કંડારનાર\V_VAUX_VNP સમર્થ\JJ શિલ્પીઓના\N_NN સિંધુસમ\JJ જીવનકવનમાંથી\N_NN બિંદુ\N_NN આપણે\PR_PRP આચમન\N_NN કર્યું\V_VM .\RD_PUNC
GJRED606	આપણે\PR_PRP તેમના\PR_PRP જીવનમાંથી\N_NN તેમણે\PR_PRP બતાવેલા\V_VAUX_VNP આદર્શોને\N_NN સિદ્ધાંતોને\N_NN જીવનમાં\N_NN ઊતારીએ\V_VM અને\CC_CCD તેમના\PR_PRP ચરણોમાં\N_NN શત્\JJ શત્\JJ વંદન\N_NN કરી\V_VM કૃતાર્થ\JJ બનીએ\V_VM .\RD_PUNC
GJRED607	કાળની\N_NN ત્રણ\QT_QTC અવસ્થાઓ\N_NN એટલે\PSP ભૂત\N_NN ,\RD_PUNC વર્તમાન\N_NN અને\CC_CCD ભવિષ્ય\N_NN .\RD_PUNC
GJRED608	એમાં\DM_DMD વિશેષ\JJ મહત્ત્વ\N_NN છે\V_VAUX વર્તમાનનું\N_NN .\RD_PUNC
GJRED609	વર્તમાન\N_NN એટલે\PSP વર્તમાન\N_NN .\RD_PUNC
GJRED610	વર્તમાન\JJ જીવન\N_NN જ\RP_RPD સાચું\JJ .\RD_PUNC
GJRED611	કહો\V_VM કે\CC_CCS આજની\N_NST ઘડી\N_NN રળિયામણી\JJ .\RD_PUNC
GJRED612	વર્તમાનની\N_NN આમ\PSP સર્વથા\JJ ઉપેક્ષા\N_NN કરીને\V_VAUX_VNP તે\DM_DMD કોઈ\PR_PRI સફળતા\N_NN મેળવી\V_VM શકતો\V_VAUX_VNP નથી\RP_NEG .\RD_PUNC
GJRED613	આવી\JJ સ્થિતિમાં\N_NN તેણે\PR_PRP વર્તમાનને\N_NN સફળ\JJ બનાવવા\V_VAUX_VNP માટે\PSP થોડો\QT_QTF વિચાર\N_NN કરવાની\V_VAUX_VNP જરૂર\N_NN છે\V_VAUX .\RD_PUNC
GJRED614	એ\DM_DMD માટે\PSP તેણે\PR_PRP ભૂતકાળને\N_NN ભૂતકાળ\N_NN અને\CC_CCD ભવિષ્યને\N_NN ભવિષ્યકાળમાં\N_NN જ\RP_RPD રહેવા\V_VAUX_VNP દેવો\V_VAUX_VNP જોઈએ\V_VAUX .\RD_PUNC
GJRED615	મનુષ્ય\N_NN આ\DM_DMD રીતે\N_NN પોતાની\PR_PRF મનઃસ્થિતિનું\N_NN ઘડતર\N_NN કરે\V_VM એટલે\PSP ભયોભયો\PSP .\RD_PUNC
GJRED616	વર્તમાનમાં\N_NN જ\RP_RPD અનેક\JJ વિભૂતિઓ\N_NN અને\CC_CCD ઉપલબ્ધિઓ\N_NN ભરી\V_VM છે\V_VAUX .\RD_PUNC
GJRED617	વર્તમાનમાં\N_NN જીવવાથી\V_VAUX_VNP તેનામાં\PR_PRP સ્વાભાવિક\JJ રીતે\N_NN જ\RP_RPD એકાગ્રતા\N_NN આવે\V_VM છે\V_VAUX .\RD_PUNC
GJRED618	એની\DM_DMD બીજી\JJ ઉપલબ્ધિ\N_NN છે\V_VAUX કુશળતા\N_NN .\RD_PUNC
GJRED619	જ્યારે\N_NST કોઈ\PR_PRI મનુષ્ય\N_NN કાર્યને\N_NN એકાગ્રતાપૂર્વક\RB કરે\V_VM છે\V_VAUX ત્યારે\N_NST તે\PR_PRP ખૂબ\QT_QTF જલદીથી\RB એ\DM_DMD વિષયમાં\N_NN કુશળ\JJ બની\V_VM જાય\V_VAUX છે\V_VAUX .\RD_PUNC
GJRED620	ત્રીજી\JJ ઉપલબ્ધિ\N_NN છે\V_VAUX સર્જન\N_NN .\RD_PUNC
GJRED621	એકાગ્રતાથી\N_NN મૌલિકતાનો\N_NN વિકાસ\N_NN થાય\V_VM છે\V_VAUX .\RD_PUNC
GJRED622	ચોથી\JJ ઉપલબ્ધિ\N_NN છે\V_VAUX અંતઃજ્ઞાન\N_NN .\RD_PUNC
GJRED623	જ્યારે\N_NST મનુષ્ય\N_NN કોઈ\DM_DMI કાર્ય\N_NN કરવા\V_VAUX_VNP પ્રત્યે\PSP એકાગ્ર\JJ થાય\V_VM છે\V_VAUX ત્યારે\N_NST તેને\PR_PRP એકાગ્રતાના\N_NN ફલસ્વરૂપે\N_NN અંદરથી\N_NST જ્ઞાન\N_NN પ્રાપ્ત\JJ થવા\V_VAUX_VNP લાગે\V_VM છે\V_VAUX .\RD_PUNC
GJRED624	આ\DM_DMD રીતે\N_NN મનુષ્ય\N_NN વર્તમાનનો\N_NN સદુપયોગ\N_NN કરીને\V_VAUX_VNP જીવનશ્રેય\N_NN મેળવી\V_VM શકે\V_VAUX છે\V_VAUX .\RD_PUNC
GJRED625	સાચા\JJ વક્તાનું\N_NN લક્ષણ\N_NN શું\PR_PRQ ?\RD_PUNC
GJRED626	આવું\JJ સાચું\JJ વક્તૃત્વ\N_NN પૂ.\JJ આ.\JJ શ્રીમદ્દ\N_NNP રામચન્દ્રસૂરીશ્વરજી\N_NNP મહારાજમાં\N_NNP બાલ્યવયથી\N_NN જ\RP_RPD ખીલેલું\V_VAUX_VNP હતું\V_VAUX .\RD_PUNC
GJRED627	એની\PR_PRP પ્રતીતિ\N_NN કરાવી\V_VAUX_VNP જતો\V_VAUX_VNP એક\QT_QTC પ્રસંગ\N_NN જાણવા\V_VAUX_VNP જેવો\JJ છે\V_VAUX .\RD_PUNC
GJRED628	તારીખ\N_NN ૨૧/૭/૧૯૨૯ના\N_NNP ``\RD_PUNC જૈન\N_NNP પ્રવચનમાં\N_NN ``\RD_PUNC પ્રસિદ્ધ\JJ થયેલ\V_VAUX_VNP છે\V_VAUX .\RD_PUNC
GJRED629	પૂજ્ય\JJ મુનિરાજશ્રી\N_NN રામવિજયજી\N_NNP મહારાજના\N_NN પ્રવચનમાં\N_NN એ\DM_DMD ભાવના\N_NN શબ્દો\N_NN આગળ\PSP પાછળના\PSP પૂરા\JJ સંદર્ભ\N_NN સાથે\PSP આલેખિત\JJ હતા\V_VAUX .\RD_PUNC
GJRED630	આજે\N_NST સારા\JJ ઘરે\N_NN પણ\RP_RPD અભક્ષ્ય\JJ અપેયનો\JJ વિચાર\N_NN નથી\RP_NEG થતો\V_VAUX_VNP .\RD_PUNC
GJRED631	જૈન\N_NN અભક્ષ્ય\JJ ખાન\N_NN -\RD_PUNC પાન\N_NN કરતા\V_VAUX_VNP હોય\V_VAUX ,\RD_PUNC એને\DM_DMD ઉદ્દેશીને\V_VAUX_VNP જ\RP_RPD આ\DM_DMD વાક્ય\N_NN બોલાયેલું\V_VAUX_VNP હતું\V_VAUX !\RD_PUNC
GJRED632	થોડા\QT_QTF જ\RP_RPD દિવસોમાં\N_NN વિરોધી\JJ વર્ગે\N_NN કાગનો\N_NN વાઘ\N_NN કરીને\V_VAUX_VNP આ\DM_DMD પ્રશ્નને\N_NN પત્ર\N_NN અને\CC_CCD પત્રિકાઓ\N_NN દ્વારા\PSP એ\DM_DMD રીતે\N_NN ચગાવ્યો\V_VM .\RD_PUNC
GJRED633	ઠેરઠેર\PSP આ\DM_DMD વાત\N_NN જ\RP_RPD વિવાદ\N_NN બનીને\V_VAUX_VNP ચર્ચામાં\N_NN માંડી\V_VAUX .\RD_PUNC
GJRED634	એમને\PR_PRP એ\DM_DMD માર્ગેથી\N_NN પાછા\RB વાળવા\V_VAUX_VNP માટે\PSP જ\RP_RPD આ\DM_DMD વાક્ય\N_NN ઉચ્ચારાયું\V_VM છે\V_VAUX .\RD_PUNC
GJRED635	આમ\PSP છતાં\RP_RPD આ\DM_DMD વિવાદ\N_NN ન\RP_NEG જ\RP_RPD શમ્યો\V_VM .\RD_PUNC
GJRED636	ત્યારે\N_NST પૂ.\JJ આ.\JJ શ્રી\N_NN સાગરાનંદસૂરિજી\N_NNP મહારાજ\N_NNP જામનગરમાં\N_NNP બિરાજમાન\JJ હતા\V_VAUX .\RD_PUNC
GJRED637	જે\PR_PRL કોઈ\PR_PRI પણ\RP_RPD કોર્ટમાં\N_NN બદનક્ષીનો\N_NN કેસ\N_NN ચાલે\V_VM ,\RD_PUNC તો\CC_CCD તે\DM_DMD કોર્ટ\N_NN પણ\RP_RPD માત્ર\RP_RPD એક\QT_QTC જ\RP_RPD વાક્યના\N_NN શબ્દો\N_NN ઉપરથી\PSP બદનક્ષી\N_NN થઈ\V_VM ,\RD_PUNC એમ\PSP માનતી\V_VAUX_VNP નથી\RP_NEG .\RD_PUNC
GJRED638	કોર્ટ\N_NN આખા\JJ પેરેગ્રાફ\N_NN અને\CC_CCD પ્રકરણ\N_NN ઉપર\PSP ધ્યાન\N_NN આપે\V_VM છે\V_VAUX .\RD_PUNC
GJRED639	આ\DM_DMD વાત\N_NN જો\CC_CCD ખ્યાલમાં\N_NN રાખવામાં\V_VAUX_VNP આવે\V_VAUX ,\RD_PUNC તો\CC_CCD આજકાલ\N_NST જે\PR_PRL ચર્ચા\N_NN ચકડોળે\N_NN ચડાવવામાં\V_VAUX_VNP આવી\V_VAUX છે\V_VAUX એ\DM_DMD શાંત\JJ થઈ\V_VM જાય\V_VAUX .\RD_PUNC
GJRED640	જૈનોના\N_NN ઘરે\N_NN પણ\RP_RPD દારૂના\N_NN શીશા\N_NN અને\CC_CCD ઈંડા\N_NN ચટણીની\N_NN જેમ\JJ ખવાય\V_VM છે\V_VAUX .\RD_PUNC
GJRED641	આ\DM_DMD વાક્ય\N_NN મુનિવર્ય\N_NN શ્રી\N_NN રામવિજયજીએ\N_NNP કહ્યું\V_VM છે\V_VAUX .\RD_PUNC
GJRED642	તેમાં\DM_DMD કોઈ\PR_PRI ના\RP_NEG પાડતું\V_VAUX_VNP નથી\RP_NEG ,\RD_PUNC ખુદ\PR_PRF તેઓ\PR_PRP પણ\RP_RPD આ\DM_DMD વિષયમાં\N_NN ના\RP_NEG પાડતા\V_VAUX_VNP નથી\RP_NEG .\RD_PUNC
GJRED643	પણ\CC_CCD તમે\PR_PRP આખું\JJ પ્રકરણ\N_NN અને\CC_CCD આખો\JJ પેરેગ્રાફ\N_NN વાંચો\V_VM ,\RD_PUNC તો\CC_CCD વક્તાનો\N_NN આશય\N_NN શો\PR_PRQ છે\V_VAUX ,\RD_PUNC એ\DM_DMD તરત\PSP જ\RP_RPD સમજી\V_VM શકશો\V_VAUX .\RD_PUNC
GJRED644	જેઓ\PR_PRL બધા\QT_QTF જૈનોને\N_NN આ\DM_DMD વાક્ય\N_NN લાગુ\JJ પાડવા\V_VAUX_VNP માંગે\V_VM છે\V_VAUX ,\RD_PUNC તેઓની\PR_PRL ધારણા\N_NN ભૂલ\N_NN ભરેલી\V_VAUX_VNP છે\V_VAUX .\RD_PUNC
GJRED645	અંતે\N_NN આ\DM_DMD વિવાદ\N_NN મુંબઈ\N_NNP હાઈકોર્ટના\N_NN એડવોકેટ\N_NN જનરલ\JJ સર\N_NN જે.બી.\N_NNP કાંગા\N_NNP આદિ\PSP સમક્ષ\JJ પહોંચ્યો\V_VM .\RD_PUNC
GJRED646	અને\CC_CCD એથી\PSP ય\RP_RPD આગળ\PSP વધીને\V_VAUX_VNP આ\DM_DMD વિષયમાં\N_NN ગાંધીજીએ\N_NNP પોતાનું\PR_PRF નીચે\N_NST મુજબનું\PSP મંતવ્ય\N_NN જાહેર\JJ કર્યું\V_VM .\RD_PUNC
GJRED647	જે\PR_PRL વાક્યનો\N_NN ઊહાપોહ\N_NN તમે\PR_PRP કર્યો\V_VM છે\V_VAUX એને\DM_DMD હું\PR_PRP નિર્દોષ\JJ વાક્ય\N_NN ગણું\V_VM છું\V_VAUX .\RD_PUNC
GJRED648	એમાં\DM_DMD જૈન\N_NN માત્ર\RP_RPD ઉપર\PSP આક્ષેપ\N_NN નથી\RP_NEG .\RD_PUNC
GJRED649	પણ\CC_CCD જે\PR_PRL જૈનો\N_NN અખાદ્ય\JJ વસ્તુ\N_NN ખાય\V_VM છે\V_VAUX ,\RD_PUNC તેની\PR_PRL ઉપર\PSP આક્ષેપ\N_NN છે\V_VAUX .\RD_PUNC
GJRED650	ગાંધીજીએ\N_NNP જ્યારે\N_NST આ\DM_DMD રીતે\N_NN શ્રી\N_NN રામવિજયજી\N_NNP મહારાજની\N_NNP વાત\N_NN પર\PSP સચ્ચાઈનો\N_NN સિક્કો\N_NN માર્યો\V_VM ,\RD_PUNC ત્યારે\N_NST વિરોધીઓનો\N_NN વિરોધ\N_NN હવા\N_NN વિનાના\PSP ફુગ્ગા\N_NN જેવો\JJ નિષ્પ્રાણ\JJ બની\V_VM જવા\V_VAUX_VNP પામ્યો\V_VM .\RD_PUNC
GJRED651	શત્રુઓના\N_NN નગર\N_NN હસ્તિનાપુરમાં\N_NNP રહેવાનો\V_VAUX_VNP કુંતીએ\N_NNP નિર્ધાર\N_NN કર્યો\V_VM !\RD_PUNC
GJRED652	દ્યુતસભામાં\N_NN પરાજિત\JJ થયેલા\V_VAUX_VNP પાંડવોને\N_NN બાર\QT_QTC વર્ષનો\N_NN વનવાસ\N_NN ને\CC_CCD એક\QT_QTC વર્ષનો\N_NN અજ્ઞાતવાસ\N_NN વેઠવાનો\V_VAUX_VNP આવ્યો\V_VAUX .\RD_PUNC
GJRED653	તેર\QT_QTC વર્ષના\N_NN આ\DM_DMD સમયગાળામાં\N_NN સંતાનોને\N_NN એમની\PR_PRP પત્ની\N_NN સાથે\PSP મોકળાશથી\N_NN જીવવા\V_VAUX_VNP મળે\V_VM ,\RD_PUNC તે\DM_DMD માટે\PSP કુંતીએ\N_NNP એમની\PR_PRP સાથે\PSP વનમાં\N_NN જવાની\V_VAUX_VNP અનિચ્છા\N_NN પ્રગટ\JJ કરી\V_VM .\RD_PUNC
GJRED654	પાંડુપુત્રોને\N_NN સ્વાભાવિક\JJ રીતે\N_NN જ\RP_RPD એમની\PR_PRP રાજધાની\N_NN ઈન્દ્રપ્રસ્થનું\N_NNP સ્મરણ\N_NN થયું\V_VM .\RD_PUNC
GJRED655	તો\CC_CCD પછી\PSP માતા\N_NN તમે\PR_PRP રહો\V_VM આપણી\PR_PRP રાજધાની\N_NN ઈન્દ્રપ્રસ્થમાં\N_NNP !\RD_PUNC
GJRED656	હા\PSP ,\RD_PUNC ઈન્દ્રપ્રસ્થમાં\N_NNP તમને\PR_PRP કોઈ\DM_DMI અસુવિધા\N_NN નહીં\RP_NEG હોય\V_VAUX .\RD_PUNC
GJRED657	માતા\N_NN જીવે\V_VM ત્યાં\N_NST સુધી\PSP એ\PR_PRP એના\PR_PRP શ્વાસમાં\N_NN સંતાનોની\N_NN ચિંતા\N_NN લઈને\V_VAUX_VNP જીવતી\V_VAUX_VNP હોય\V_VAUX છે\V_VAUX .\RD_PUNC
GJRED658	એ\PR_PRP કોઈ\DM_DMI પણ\RP_RPD સ્થળે\N_NN હોય\V_VAUX ,\RD_PUNC તો\CC_CCD પણ\RP_RPD એને\DM_DMD પળેપળ\N_NN અને\CC_CCD ક્ષણેક્ષણ\N_NN પોતાના\PR_PRF પુત્રોની\N_NN ચિંતા\N_NN સતાવતી\V_VAUX_VNP હોય\V_VAUX છે\V_VAUX .\RD_PUNC
GJRED659	સવારે\N_NST ઊઠે\V_VM ત્યારથી\N_NST રાત્રે\N_NST સુએ\V_VM ત્યાં\N_NST સુધી\PSP ,\RD_PUNC એના\PR_PRP ચિત્તમાં\N_NN વિખૂટા\JJ પડેલા\V_VAUX_VNP પુત્રોની\N_NN ચિંતા\N_NN વસતી\V_VAUX_VNP હોય\V_VAUX છે\V_VAUX .\RD_PUNC
GJRED660	સ્વપ્નોમાં\N_NN પણ\RP_RPD ,\RD_PUNC એને\DM_DMD પુત્રની\N_NN ફિકરનાં\N_NN જ\RP_RPD સ્વપ્નાં\N_NN આવતાં\V_VAUX_VNP હોય\V_VAUX છે\V_VAUX .\RD_PUNC
GJRED661	કોઈ\PR_PRI પણ\RP_RPD વ્યક્તિ\N_NN ,\RD_PUNC સ્થિતિ\N_NN કે\CC_CCS સ્થળમાં\N_NN હોઈશ\V_VAUX ,\RD_PUNC તો\CC_CCD પણ\RP_RPD હું\PR_PRP ચિંતામુક્ત\JJ નહીં\RP_NEG હોઉં\V_VAUX .\RD_PUNC
GJRED662	તો\CC_CCD પછી\PSP માતા\N_NN તમે\PR_PRP કયા\DM_DMQ સ્થાનમાં\N_NN રહેવા\V_VAUX_VNP ઈચ્છો\V_VM છો\V_VAUX ?\RD_PUNC
GJRED663	તમારે\PR_PRP માટે\PSP અમને\PR_PRP લાગે\V_VM છે\V_VAUX કે\CC_CCS સૌથી\JJ શ્રેષ્ઠ\JJ સ્થાન\N_NN તો\RP_RPD પાંડવોની\N_NNP રાજધાની\N_NN ઈન્દ્રપ્રસ્થનો\N_NNP રાજપ્રસાદ\N_NNP છે\V_VAUX .\RD_PUNC
GJRED664	પરંતુ\CC_CCD જો\CC_CCD તમારે\PR_PRP ઈન્દ્રપ્રસ્થમાં\N_NNP રહેવું\V_VAUX_VNP ન\RP_NEG હોય\V_VAUX ,\RD_PUNC તો\CC_CCD તમે\PR_PRP મહારાજ\N_NN કુંતીભોજની\N_NNP નગરી\N_NN વા\PSP તમારા\PR_PRP પિયર\N_NN ભોજપુરમાં\N_NNP જાવ\V_VM તો\RP_RPD ?\RD_PUNC
GJRED665	હા\PSP ,\RD_PUNC એ\DM_DMD બરાબર\PSP .\RD_PUNC
GJRED666	માતા\N_NN !\RD_PUNC તમને\PR_PRP પિયરમાં\N_NN તો\RP_RPD પારાવાર\JJ સુખ\N_NN મળશે\V_VM ખરું\RP_RPD ને\RP_RPD !\RD_PUNC
GJRED667	જે\PR_PRL દિવસે\N_NST સ્વયંવરમાં\N_NN દિગ્વિજયી\JJ પાંડુના\N_NNP કંઠમાં\N_NN વરમાળા\N_NN આરોપી\V_VM ,\RD_PUNC એ\DM_DMD દિવસથી\N_NN જ\RP_RPD મારે\PR_PRP મન\N_NN પિયર\N_NN પારકું\JJ બની\V_VM ગયું\V_VAUX .\RD_PUNC
GJRED668	ભોજપુર\N_NNP છોડ્યા\V_VAUX_VNP પછી\PSP એના\DM_DMD તરફ\PSP પાછા\RB ફરીને\V_VAUX_VNP મેં\PR_PRP ક્યારેય\N_NST જોયું\V_VM નથી\RP_NEG .\RD_PUNC
GJRED669	શ્રીકૃષ્ણ\N_NNP ,\RD_PUNC બલરામ\N_NNP અને\CC_CCD અક્રૂરને\N_NNP જોઈને\V_VAUX_VNP મારી\PR_PRP આંખો\N_NN ઠરી\V_VM છે\V_VAUX .\RD_PUNC
GJRED670	પરંતુ\CC_CCD ક્યારેય\N_NST પિયર\N_NN જવાનો\V_VAUX_VNP મેં\PR_PRP વિચાર\N_NN સુદ્ધાં\RP_RPD કર્યો\V_VM નથી\RP_NEG .\RD_PUNC
GJRED671	મારે\PR_PRP મન\N_NN પિયર\N_NN એ\PSP દુ:ખની\N_NN પળોનો\N_NN આશરો\N_NN કે\CC_CCS નિરાંતની\N_NN સુખ\N_NN -\RD_PUNC સુવિધાનું\N_NN સ્થાન\N_NN નથી\RP_NEG .\RD_PUNC
GJRED672	માટે\PSP હું\PR_PRP પિયરમાં\N_NN નિવાસ\N_NN કરવા\V_VAUX_VNP ચાહતી\V_VAUX_VNP નથી\RP_NEG .\RD_PUNC
GJRED673	તમે\PR_PRP સુવર્ણમયી\JJ દ્વારિકામાં\N_NNP જઈને\V_VAUX_VNP વસો\V_VM .\RD_PUNC
GJRED674	ભલે\PSP દ્વારિકા\N_NNP તમારું\PR_PRP પિયર\N_NN ન\RP_NEG હોય\V_VAUX .\RD_PUNC
GJRED675	એ\DM_DMD દ્વારિકામાં\N_NNP શ્રીકૃષ્ણ\N_NNP અને\CC_CCD બલરામ\N_NNP છે\V_VAUX .\RD_PUNC
GJRED676	શ્રીકૃષ્ણ\N_NNP પ્રત્યેનો\PSP તમારો\PR_PRP ભક્તિભાવ\N_NN હું\PR_PRP જાણું\V_VM છું\V_VAUX .\RD_PUNC
GJRED677	સંસારની\N_NN સઘળી\JJ ઘટનાઓનો\N_NN મર્મ\N_NN પામી\V_VM શકે\V_VAUX છે\V_VAUX .\RD_PUNC
GJRED678	શ્રીકૃષ્ણની\N_NNP દ્વારિકા\N_NNP જેવું\JJ બીજું\JJ સ્થાન\N_NN તમારે\PR_PRP માટે\PSP કયું\DM_DMQ હોય\V_VAUX ?\RD_PUNC
GJRED679	પરમ\JJ સાનિધ્ય\N_NN તમારા\PR_PRP ભક્તિપૂર્ણ\JJ હૃદયને\N_NN સદૈવ\JJ અતિ\JJ પ્રસન્ન\JJ કરશે\V_VM .\RD_PUNC
GJRED680	કુંતીએ\N_NNP અસ્વીકારમાં\N_NN માથું\N_NN ધૂણાવતા\V_VAUX_VNP કહ્યું\V_VM ,\RD_PUNC ના\RP_NEG ,\N_NN વીર\JJ અર્જુન\N_NNP ,\RD_PUNC હવે\N_NST તો\RP_RPD દ્વારિકા\N_NNP જઈને\V_VAUX_VNP રહી\V_VM શકું\V_VAUX તેવું\JJ નથી\RP_NEG .\RD_PUNC
GJRED681	માતા\N_NN એવું\JJ તે\PSP શું\PR_PRQ થયું\V_VM છે\V_VAUX કે\CC_CCS તમે\PR_PRP દ્વારિકા\N_NNP જવાની\V_VAUX_VNP વાતનો\N_NN છેદ\N_NN ઉડાડી\V_VM દો\V_VAUX છો\V_VAUX ?\RD_PUNC
GJRED682	માતા\N_NN અક્રૂરને\N_NNP જોતાં\V_VAUX_VNP તમારી\PR_PRP આંખોમાં\N_NN થયેલા\V_VAUX_VNP આનંદને\N_NN અમે\PR_PRP ભાંડુઓ\N_NN હજી\N_NST યાદ\V_VM કરીએ\V_VM છીએ\V_VAUX .\RD_PUNC
GJRED683	કૃષ્ણ\N_NNP અને\CC_CCD બલરામ\N_NNP પ્રત્યેનો\PSP તમારો\PR_PRP પ્રબળ\JJ અહોભાવ\N_NN અમારી\PR_PRP આંખોથી\N_NN છૂપો\JJ રહી\V_VM શક્યો\V_VAUX નથી\RP_NEG .\RD_PUNC
GJRED684	તો\RP_RPD પછી\PSP એમની\PR_PRP નગરીમાં\N_NN એમના\PR_PRP પરમ\JJ સાન્નિધ્યમાં\N_NN નિવાસ\N_NN કરવાનો\V_VAUX_VNP ઈન્કાર\N_NN શાને\PR_PRQ ?\RD_PUNC
GJRED685	શ્રીકૃષ્ણ\N_NNP અને\CC_CCD બલરામ\N_NNP આપણે\PR_PRP બોલાવીએ\V_VM ત્યારે\N_NST સહાયતા\N_NN કરવા\V_VAUX_VNP કેવા\DM_DMQ હોંશે\RB હોંશે\RB હાજર\JJ થઈ\V_VM જાય\V_VAUX છે\V_VAUX !\RD_PUNC
GJRED686	મારે\PR_PRP માટે\PSP હવે\N_NST સુવર્ણમયી\JJ દ્વારિકામાં\N_NNP જઈને\V_VAUX_VNP વસવાનું\V_VAUX_VNP દુષ્કર\JJ બન્યું\V_VM છે\V_VAUX .\RD_PUNC
GJRED687	મારો\PR_PRP પ્રિય\JJ અર્જુન\N_NNP શ્રીકૃષ્ણની\N_NNP બહેન\N_NN સુભદ્રા\N_NNP સાથે\PSP લગ્નગ્રંથિથી\N_NN જોડાયો\V_VM ,\RD_PUNC ત્યારથી\N_NST મારે\PR_PRP માટે\PSP દ્વારિકા\N_NNP એ\DM_DMD હવે\N_NST મારા\PR_PRP પિયરના\N_NN સ્વજનોનું\N_NN નગર\N_NN નથી\RP_NEG .\RD_PUNC
GJRED688	ભીમે\N_NNP અર્જુનને\N_NNP ઉદ્દેશીને\V_VAUX_VNP હળવાશથી\RB કહ્યું\V_VM ,\RD_PUNC ``\RD_PUNC લઘુબંધુ\N_NN ,\RD_PUNC કોઈ\PR_PRI નારીનું\N_NN હરણ\N_NN કરતા\V_VAUX_VNP પૂર્વે\N_NST પોતાના\PR_PRF પરિવારનો\N_NN પૂર્ણતયા\JJ વિચાર\N_NN કરવો\V_VAUX_VNP જોઈએ\V_VAUX .\RD_PUNC
GJRED689	તમે\PR_PRP સુભદ્રાનું\N_NNP હરણ\N_NN કરવાની\V_VAUX_VNP સાથે\PSP માતાના\N_NN પિયર\N_NN પક્ષ\N_NN સાથેના\PSP સંબંધનું\N_NN ય\RP_RPD હરણ\N_NN કર્યું\V_VM .\RD_PUNC
GJRED690	લગ્નની\N_NN ઉતાવળમાં\N_NN સંબંધો\N_NN કેવા\DM_DMQ ભગ્ન\JJ થઈ\V_VM જાય\V_VAUX છે\V_VAUX ,\RD_PUNC લઘુબંધુ\N_NN .\RD_PUNC
GJRED691	વાહ\RP_INJ ભીમસેન\N_NNP ,\RD_PUNC તારી\PR_PRP દૂરંદેશી\JJ જોઈને\V_VAUX_VNP તારો\PR_PRP જ્યેષ્ઠ\JJ બંધુ\N_NN યુધિષ્ઠર\N_NNP તારા\PR_PRP પર\PSP અતિ\JJ પ્રસન્ન\JJ થયો\V_VM છે\V_VAUX .\RD_PUNC
GJRED692	પિયર\N_NN ભોજપુરમાં\N_NNP કે\CC_CCS બંધુ\N_NN વસુદેવના\N_NNP દ્વારિકામાં\N_NNP વસવા\V_VAUX_VNP ઈચ્છતી\V_VAUX_VNP નથી\RP_NEG .\RD_PUNC
GJRED693	ઈન્દ્રપ્રસ્થમાં\N_NNP પણ\RP_RPD રહેવું\V_VAUX_VNP નથી\RP_NEG .\RD_PUNC
GJRED694	રાજમહેલના\N_NN વૈભવમાં\N_NN પણ\RP_RPD વસવું\V_VAUX_VNP નથી\RP_NEG .\RD_PUNC
GJRED695	કાકા\N_NN વિદુરજી\N_NNP !\RD_PUNC તમે\PR_PRP નીતિશાસ્ત્રમાં\N_NN પારંગત\JJ છો\V_VAUX .\RD_PUNC
GJRED696	મહાત્મા\JJ વિદુર\N_NNP ગહન\N_NN વિચારમાં\N_NN પડી\V_VM ગયા\V_VAUX .\RD_PUNC
GJRED697	એમને\PR_PRP સમજાતું\V_VAUX_VNP નહોતું\RP_NEG કુંતી\N_NNP આ\DM_DMD તેર\QT_QTC વર્ષની\N_NN લાંબી\JJ અવધિ\N_NN ક્યાં\N_NST વ્યતીત\JJ કરશે\V_VM .\RD_PUNC
GJRED698	લગ્ન\N_NN પછી\PSP નારીનું\N_NN એક\QT_QTC જ\RP_RPD સ્થાન\N_NN હોય\V_VAUX છે\V_VAUX અને\CC_CCD તે\DM_DMD એનું\PR_PRP શ્વસુરગૃહ\N_NN .\RD_PUNC
GJRED699	હું\PR_PRP મારા\PR_PRP શ્વસુરગૃહે\N_NN રહીને\V_VAUX_VNP તેર\QT_QTC વર્ષનો\N_NN સમય\N_NN વ્યતીત\JJ કરીશ\V_VM .\RD_PUNC
GJRED700	તમે\PR_PRP દ્વેષ\N_NN ,\RD_PUNC વેર\N_NN અને\CC_CCD પ્રપંચથી\N_NN ભરેલા\V_VAUX_VNP એવા\JJ હસ્તિનાપુરમાં\N_NNP વસવા\V_VAUX_VNP માંગો\V_VM છો\V_VAUX ?\RD_PUNC
GJRED701	ભીમ\N_NNP એકાએક\PSP બોલી\V_VM ઊઠ્યો\V_VAUX .\RD_PUNC
GJRED702	અરે\RP_INJ આ\DM_DMD નગરી\N_NN ,\RD_PUNC જે\PR_PRL નગરીની\N_NN હવામાં\N_NN સર્વત્ર\JJ પાંડવો\N_NNP સામેના\PSP પ્રપંચની\N_NN દુર્ગંધ\N_NN પ્રસરતી\PSP રહે\V_VAUX છે\V_VAUX .\RD_PUNC
GJRED703	જેની\PR_PRL ભૂમિ\N_NN પર\PSP અવિરત\JJ રૂપે\N_NN પાંડવોની\N_NNP હત્યાના\N_NN ષડયંત્રો\N_NN રચાયાં\V_VAUX_VNP કરે\V_VM છે\V_VAUX .\RD_PUNC
GJRED704	જ્યાં\N_NST રાજવીઓના\N_NN મનમાં\N_NN પાંડુપુત્રો\N_NNP પ્રત્યે\PSP વેરનો\N_NN પ્રબળ\JJ અગ્નિ\N_NN વધુ\QT_QTF પ્રદીપ્ત\JJ થતો\V_VAUX_VNP રહે\V_VAUX છે\V_VAUX .\RD_PUNC
GJRED705	આકાશમાંથી\N_NN પાંડવોના\N_NNP નાશ\N_NN માટેના\PSP યુદ્ધનાં\N_NN દુંદુભિનાં\N_NN અવાજો\N_NN પ્રતિધ્વનિત\JJ થતા\V_VAUX_VNP હોય\V_VAUX છે\V_VAUX .\RD_PUNC
GJRED706	માતા\N_NN આવા\JJ શત્રુનગર\N_NN હસ્તિનાપુરમાં\N_NNP તમે\PR_PRP વસવાનું\V_VAUX_VNP વિચારો\V_VM છો\V_VAUX ?\RD_PUNC
GJRED707	નકુળે\N_NNP ધ્રૂજતા\V_VAUX_VNP અવાજે\N_NN કહ્યું\V_VM ,\RD_PUNC આ\DM_DMD તો\RP_RPD સામે\PSP ચાલીને\V_VAUX_VNP સાપના\N_NN રાફડામાં\N_NN હાથ\N_NN નાખવાની\V_VAUX_VNP વાત\N_NN થઈ\V_VM .\RD_PUNC
GJRED708	એનું\DM_DMD પરિણામ\N_NN તો\RP_RPD જીવલેણ\JJ જ\RP_RPD આવે\V_VM .\RD_PUNC
GJRED709	કુંતી\N_NNP હસી\V_VM પડી\V_VAUX .\RD_PUNC
GJRED710	આંખોમાં\N_NN કોઈ\DM_DMI અજબ\JJ ક્ષાત્રતેજનો\N_NN પાંડવોને\N_NNP અનુભવ\N_NN થયો\V_VM .\RD_PUNC
GJRED711	વીર\JJ ક્ષત્રિયાણીની\N_NN છટા\N_NN ખીલી\V_VM ઊઠી\V_VAUX .\RD_PUNC
GJRED712	તમને\PR_PRP ભલે\PSP એ\DM_DMD શત્રુઓનું\N_NN નગર\N_NN લાગતું\V_VAUX_VNP હોય\V_VAUX ,\RD_PUNC પણ\RP_RPD મને\CC_CCD એનો\DM_DMD સહેજ\QT_QTF પણ\RP_RPD ભય\N_NN નથી\RP_NEG .\RD_PUNC
GJRED713	મારું\PR_PRP હૃદયબળ\N_NN મારામાં\PR_PRP સંકલ્પ\N_NN જગાવે\V_VM છે\V_VAUX  .\RD_PUNC
GJRED714	તમે\PR_PRP હસ્તિનાપુરમાં\N_NNP તેર\QT_QTC વર્ષ\N_NN તો\RP_RPD શું\PR_PRQ ,\RD_PUNC તેર\QT_QTC દિવસ\N_NN તો\RP_RPD શું\PR_PRQ ,\RD_PUNC તેર\QT_QTC ઘડી\N_NN પણ\RP_RPD સુરક્ષિત\JJ નથી\RP_NEG .\RD_PUNC
GJRED715	ના\RP_NEG માતા\N_NN ,\RD_PUNC ના\RP_NEG .\RD_PUNC
GJRED716	મારે\PR_PRP માટે\PSP તેર\QT_QTC વર્ષનો\N_NN અવધિકાળ\N_NN હસ્તિનાપુરમાં\N_NNP પસાર\JJ કરવો\V_VAUX_VNP આવશ્યક\JJ અને\CC_CCD અનિવાર્ય\JJ છે\V_VAUX ,\RD_PUNC વીરપુત્રો\N_NN .\RD_PUNC
GJRED717	મહાત્મા\JJ વિદુરે\N_NNP ચિંતિત\JJ દ્વિધાભરી\N_NN આંખે\N_NN કુંતીને\N_NNP નિહાળતા\V_VAUX_VNP કહ્યું\V_VM ,\RD_PUNC તમારો\PR_PRP આ\DM_DMD દિયર\N_NN કુટિલ\JJ રાજનીતિના\N_NN દાવપેચને\N_NN યથાર્થરૂપે\JJ સમજી\V_VM શકે\V_VAUX છે\V_VAUX .\RD_PUNC
GJRED718	હસ્તિનાપુરમાં\N_NNP વસતા\V_VAUX_VNP શકુનિની\N_NNP દરેક\JJ ચાલની\N_NN પાછળના\JJ હેતુની\N_NN એને\PR_PRP આસાનીથી\RB ગંધ\N_NN આવે\V_VM છે\V_VAUX .\RD_PUNC
GJRED719	કુંતીએ\N_NNP કહ્યું\V_VM ,\RD_PUNC એક\QT_QTC ક્ષત્રિયાણી\N_NN તરીકે\PSP ,\RD_PUNC દિગ્વિજયી\JJ પાંડુની\N_NN પત્ની\N_NN તરીકે\PSP અને\CC_CCD તેજસ્વી\JJ પાંડુપુત્રોની\N_NN માતા\N_NN તરીકે\PSP હસ્તિનાપુરની\N_NNP નગરીમાં\N_NN રહેવું\V_VAUX_VNP મારે\PR_PRP માટે\PSP અનિવાર્ય\JJ છે\V_VAUX .\RD_PUNC
GJRED720	કુંતી\N_NNP બોલી\V_VM ,\RD_PUNC કોણે\PR_PRQ કહ્યું\V_VM ,\RD_PUNC અરે\RP_INJ આ\DM_DMD હસ્તિનાપુરમાં\N_NNP તો\RP_RPD હું\PR_PRP અતિ\JJ સુરક્ષિત\JJ છું\V_VAUX .\RD_PUNC
GJRED721	જીવનનું\N_NN એક\QT_QTC અનિવાર્ય\JJ સત્ય\N_NN ``\RD_PUNC મોત\N_NN ``\RD_PUNC
GJRED722	તારી\PR_PRP હસ્તી\N_NN તારા\PR_PRP પાછળ\PSP એ\DM_DMD રીતે\N_NN વિસરાઈ\V_VM ગઈ\V_VAUX ,\RD_PUNC કે\CC_CCS જેમ\PSP જળમાંથી\N_NN આંગળી\N_NN કાઢીને\V_VAUX_VNP જગ્યા\N_NN પૂરાઈ\V_VM ગઈ\V_VAUX !\RD_PUNC
GJRED723	લાંબુ\JJ જીવવાની\V_VAUX_VNP જિજીવિષા\N_NN અને\CC_CCD નજીક\JJ દેખાતા\V_VAUX_VNP મોતનો\N_NN ડર\N_NN માણસ\N_NN માત્રને\RP_RPD હોય\V_VAUX છે\V_VAUX .\RD_PUNC
GJRED724	ભલે\PSP એ\PR_PRP સમજતો\V_VAUX_VNP હોય\V_VAUX કે\CC_CCS પછી\PSP એમ\PSP માનતો\V_VAUX_VNP હોય\V_VAUX કે\CC_CCS જન્મ્યા\V_VM એટલા\JJ જવાના\V_VAUX_VNP પણ\RP_RPD ,\RD_PUNC મોત\N_NN એ\DM_DMD નિશ્ચિત\JJ છે\V_VAUX .\RD_PUNC
GJRED725	બીજા\JJ અર્થમાં\N_NN કહેવું\V_VAUX_VNP હોય\V_VAUX તો\CC_CCD કહેવાય\V_VM કે\CC_CCS માણસ\N_NN એક્સપાયરી\JJ ડેટ\N_NN સાથે\PSP જ\RP_RPD જન્મતો\V_VAUX_VNP હોય\V_VAUX છે\V_VAUX .\RD_PUNC
GJRED726	આપણને\PR_PRP કશું\DM_DMI લાગતું\V_VAUX_VNP -\RD_PUNC વળગતું\V_VAUX_VNP ન\RP_NEG હોય\V_VAUX એટલે\PSP મોતના\N_NN કારમા\JJ પંજાની\N_NN વેદના\N_NN ન\RP_NEG સમજાય\V_VM .\RD_PUNC
GJRED727	બાકી\PSP જો\CC_CCD ઘરે\N_NN એ\DM_DMD સમયસર\JJ કે\CC_CCS અચાનક\PSP ત્રાટકે\V_VM છે\V_VAUX ત્યારે\N_NST સંયમ\N_NN જાળવવો\V_VAUX_VNP એ\DM_DMD કઠીન\JJ થઈ\V_VM પડે\V_VAUX છે\V_VAUX .\RD_PUNC
GJRED728	કોઈકનાં\PR_PRI સપના\N_NN ,\RD_PUNC કોઈકના\PR_PRI અરમાનો\N_NN ,\RD_PUNC કોઈની\PR_PRI નાનીસુની\JJ ઈચ્છાઓ\N_NN ,\RD_PUNC કોઈકનાં\PR_PRI આગોતરા\JJ આયોજનો\N_NN જ્યારે\N_NST મોતની\N_NN થાપટથી\N_NN રફેદફે\RB થાય\V_VM છે\V_VAUX ત્યારે\N_NST વસમુ\JJ ને\CC_CCD દોહ્યલું\JJ લાગે\V_VM છે\V_VAUX .\RD_PUNC
GJRED729	દોમ\PSP -\RD_PUNC દોમ\PSP સાહ્યબી\N_NN મારે\PR_PRP શું\PR_PRQ કરવાની\V_VAUX_VNP .\RD_PUNC
GJRED730	હવે\N_NST મારાથી\PR_PRP શે\PR_PRQ જીવાશે\V_VM ?\RD_PUNC
GJRED731	વાત\N_NN પણ\RP_RPD સાચી\JJ જ\RP_RPD છે\V_VAUX ને\RP_RPD .\RD_PUNC
GJRED732	ધીરે\RB ધીરે\RB એ\DM_DMD વેદના\N_NN ઓછી\QT_QTF થતી\V_VAUX_VNP જાય\V_VAUX તેમ\PSP છતાં\RP_RPD એક\QT_QTC વાત\N_NN ચોક્કસ\PSP છે\V_VAUX કે\CC_CCS જેણે\PR_PRL આ\DM_DMD મોતની\N_NN વેદના\N_NN અનુભવી\V_VM હોય\V_VAUX એને\PR_PRL જ\RP_RPD આ\DM_DMD વેદના\N_NN સમજાય\V_VM !\RD_PUNC
GJRED733	બીજી\JJ સત્યતા\N_NN એ\DM_DMD છે\V_VAUX કે\CC_CCS મોત\N_NN તો\RP_RPD દરેકને\JJ આવવાનું\V_VAUX_VNP જ\RP_RPD છે\V_VAUX .\RD_PUNC
GJRED734	આપણી\PR_PRP જાણ\N_NN બહાર\N_NST સમય\N_NN -\RD_PUNC સ્થળ\N_NN અને\CC_CCD સંજોગના\N_NN આગોતરા\JJ આયોજન\N_NN સાથે\PSP એની\DM_DMD સવારી\N_NN ચોક્કસ\PSP આવવાની\V_VAUX_VNP છે\V_VAUX .\RD_PUNC
GJRED735	જવા\V_VAUX_VNP માટે\PSP તો\RP_RPD આપણે\PR_PRP અહીં\N_NST આવ્યા\V_VM છીએ\V_VAUX .\RD_PUNC
GJRED736	આપણે\PR_PRP ઈચ્છીએ\V_VM તો\RP_RPD પણ\RP_RPD નથી\RP_NEG રહેવાના\V_VAUX_VNP .\RD_PUNC
GJRED737	પલભરમાં\N_NN ક્ષણભરમાં\N_NN પૂર્વજ\N_NN થઈને\V_VAUX_VNP ક્યારે\N_NST ભીંતે\N_NN લટકતા\V_VAUX_VNP થઈ\V_VM જઈએ\V_VAUX .......\RD_PUNC કહેવાય\V_VM નહિ\RP_NEG .\RD_PUNC
GJRED738	ખરેખર\PSP તો\RP_RPD મોત\N_NN ઉત્તમ\JJ ગુરુ\N_NN છે\V_VAUX .\RD_PUNC
GJRED739	એ\DM_DMD આપણને\PR_PRP શીખવે\V_VM છે\V_VAUX આપણે\PR_PRP નામશેષ\JJ થવા\V_VAUX_VNP જ\RP_RPD અહીં\N_NST આવ્યા\V_VM છીએ\V_VAUX .\RD_PUNC
GJRED740	કુદરતના\N_NN મહેમાન\N_NN બનીને\V_VAUX_VNP આવ્યા\V_VM છીએ\V_VAUX .\RD_PUNC
GJRED741	મહેમાનને\N_NN ગમો\N_NN અણગમો\N_NN કે\CC_CCS અભાવ\N_NN ન\RP_NEG પાલવે\V_VM .\RD_PUNC
GJRED742	યજમાન\N_NN જે\PR_PRL ખવરાવે\V_VM તે\PR_PRL જ\RP_RPD ખાવું\V_VAUX_VNP પડે\V_VAUX .\RD_PUNC
GJRED743	આ\DM_DMD પૃથ્વીના\N_NN રંગમંચ\N_NN ઉપર\PSP આપણે\PR_PRP કલાકાર\N_NN બની\V_VM રોલ\N_NN અદા\V_VM કરવા\V_VAUX_VNP આવ્યા\V_VM છીએ\V_VAUX .\RD_PUNC
GJRED744	અત્યારે\N_NST તમે\PR_PRP જીવનના\N_NN જે\PR_PRL પણ\RP_RPD પડાવ\N_NN પર\PSP ઊભા\JJ છો\V_VAUX એ\DM_DMD પણ\RP_RPD કલાનો\N_NN એક\QT_QTC તબક્કો\N_NN જ\RP_RPD છે\V_VAUX .\RD_PUNC
GJRED745	રોલ\N_NN ખત્મ\JJ થાય\V_VM ત્યાં\N_NST સુધી\PSP ચાલતા\V_VAUX_VNP રહેવું\V_VAUX_VNP .\RD_PUNC
GJRED746	વાહ\RP_INJ ,\RD_PUNC જીવનનો\N_NN સાર\N_NN જ\RP_RPD જાણે\PSP કે\RP_RPD !\RD_PUNC
GJRED747	કોઈના\PR_PRI રહેવા\V_VAUX_VNP ન\RP_NEG રહેવાથી\V_VAUX_VNP ક્યાં\N_NST કશો\DM_DMI ફેર\N_NN પડે\V_VM છે\V_VAUX .\RD_PUNC
GJRED748	આપણી\PR_PRP આજુબાજુ\N_NST એવા\JJ અસંખ્ય\JJ દાખલાઓ\N_NN હશે\V_VAUX .\RD_PUNC
GJRED749	આટલે\JJ સુધી\PSP કેટકેટલી\QT_QTF ચિંતાઓ\N_NN કરી\V_VAUX_VNP કરીને\V_VAUX_VNP મરી\V_VM ગયા\V_VAUX તોય\RP_RPD પરિસ્થિતિમાં\N_NN લગારેય\QT_QTF ફરક\N_NN પડ્યો\V_VM નથી\RP_NEG .\RD_PUNC
GJRED750	આપણા\PR_PRP ઘરે\N_NN ભવિષ્યમાં\N_NN કંઈ\DM_DMI નાનો\JJ -\RD_PUNC મોટો\JJ પ્રસંગ\N_NN આવે\V_VM છે\V_VAUX ત્યારે\N_NST આપણે\PR_PRP દિવસ\N_NN રાત\N_NN એક\QT_QTC કરી\V_VAUX_VNP ગોઠવણો\N_NN કરતા\V_VAUX_VNP રહીએ\V_VAUX છીએ\V_VAUX .\RD_PUNC
GJRED751	માણસાઈને\N_NN ચાર\QT_QTC ચાંદ\N_NN લગાડી\V_VM દે\V_VAUX એવા\JJ અદકેરા\JJ કામો\N_NN કરી\V_VAUX_VNP સમાજમાં\N_NN દ્રષ્ટાંતરૂપ\JJ બનેલા\V_VAUX_VNP આત્મસંતોષી\JJ -\RD_PUNC નિજાનંદી\JJ બની\V_VAUX_VNP મોતને\N_NN ભેટનાર\V_VAUX_VNP આપણા\PR_PRP અમર\JJ પાત્રોની\N_NN હરોળમાં\N_NN રહેવાની\V_VAUX_VNP કોશિષ\N_NN તો\RP_RPD કરીએ\V_VM .\RD_PUNC
GJRED752	મોતને\N_NN હરદમ\PSP વેલકમ\N_NN કહેવા\V_VAUX_VNP હાથ\N_NN લંબાવીએ\V_VM .\RD_PUNC
GJRED753	દુનિયામાં\N_NN શું\PR_PRQ લઈને\V_VAUX_VNP આવ્યા\V_VM હતા\V_VAUX ,\RD_PUNC શું\PR_PRQ લઈ\V_VM જવાના\V_VAUX_VNP !\RD_PUNC
GJRED754	જળકમળવત\JJ જીવન\N_NN એ\DM_DMD જ\RP_RPD સાચું\JJ જીવન\N_NN .\RD_PUNC
GJRED755	પરિવાર\N_NN વચ્ચે\N_NST પ્રોબ્લેમ\N_NN વચ્ચે\N_NST ,\RD_PUNC જવાબદારીઓ\N_NN વચ્ચે\N_NST જીવતાં\V_VAUX_VNP જીવતાં\V_VAUX_VNP મોતને\N_NN સ્મરવાનું\V_VAUX_VNP છે\V_VAUX .\RD_PUNC
GJRED756	હું\PR_PRP છું\V_VAUX ને\CC_CCD હું\PR_PRP નથી\RP_NEG એવો\JJ ભાવ\N_NN લાવવાનો\V_VAUX_VNP છે\V_VAUX .\RD_PUNC
GJRED757	કારણકે\CC_CCS એક\QT_QTC કવિએ\N_NN આપણને\PR_PRP ગતાગમ\N_NN પાડી\V_VM છે\V_VAUX .\RD_PUNC
GJRED758	કર્મનો\N_NN નિયમ\N_NN એ\DM_DMD જૈનશાસનનો\N_NN પ્રાણભૂત\JJ સિદ્ધાંત\N_NN છે\V_VAUX .\RD_PUNC
GJRED759	ઘણા\QT_QTF ,\RD_PUNC લગભગ\PSP બધા\QT_QTF જ\RP_RPD લોકો\N_NN ,\RD_PUNC આ\DM_DMD સિદ્ધાંતના\N_NN મર્મને\N_NN પામવામાં\V_VAUX_VNP નિષ્ફળ\JJ જતા\V_VAUX_VNP હોય\V_VAUX છે\V_VAUX .\RD_PUNC
GJRED760	એટલે\PSP તેઓ\PR_PRP આ\DM_DMD સિદ્ધાંતને\N_NN રૂક્ષ\JJ ,\RD_PUNC રસહીન\JJ ,\RD_PUNC પલાયનવાદ\N_NN ,\RD_PUNC અકર્મણ્યતા\N_NN વગેરે\PSP વિશેષણોથી\N_NN નવાજે\V_VM છે\V_VAUX .\RD_PUNC
GJRED761	પણ\CC_CCD આ\DM_DMD મંતવ્ય\N_NN બરાબર\PSP નથી\RP_NEG .\RD_PUNC
GJRED762	મનુષ્યને\N_NN સ્વતંત્રતા\N_NN અને\CC_CCD સમાનતા\N_NN -\RD_PUNC આ\DM_DMD બે\QT_QTC વાનાં\N_NN સહેજે\JJ જ\RP_RPD વધુ\QT_QTF ગમે\V_VM છે\V_VAUX ,\RD_PUNC અલબત્ત\PSP ,\RD_PUNC ભૌતિક\JJ સુખ\N_NN -\RD_PUNC સંદર્ભમાં\N_NN જ\RP_RPD .\RD_PUNC
GJRED763	લોકશાહી\N_NN માહોલમાં\N_NN આ\DM_DMD સ્થિતિનો\N_NN અનુભવ\N_NN સહુ\JJ મનુષ્યોને\N_NN સતત\JJ થયો\V_VM હોય\V_VAUX છે\V_VAUX .\RD_PUNC
GJRED764	મારી\JJ તમામ\JJ વાતો\N_NN સુવાંગ\N_NN મારી\PR_PRP હોય\V_VAUX ,\RD_PUNC મારા\PR_PRP થકી\PSP હોય\V_VAUX ,\RD_PUNC આવી\JJ ધારણા\N_NN તે\DM_DMD `\RD_PUNC સ્વતંત્રતા\N_NN .\RD_PUNC `\RD_PUNC
GJRED765	અને\CC_CCD હું\PR_PRP કોઈથી\PR_PRI નીચો\JJ નહિ\RP_NEG ,\RD_PUNC કોઈ\PR_PRI મારાથી\PR_PRP ઊંચું\JJ અથવા\CC_CCD શ્રેષ્ઠ\JJ નહિ\RP_NEG ,\RD_PUNC અમે\PR_PRP સહુ\JJ સરખા\JJ ,\RD_PUNC આવો\JJ ખ્યાલ\N_NN તે\DM_DMD `\RD_PUNC સમાનતા\N_NN .\RD_PUNC `\RD_PUNC
GJRED766	ભૌતિક\JJ સંદર્ભમાં\N_NN તેમજ\CC_CCD સામાજિક\JJ કે\CC_CCS રાજકીય\JJ લોકશાહીના\N_NN પરિપ્રેક્ષ્યમાં\N_NN ,\RD_PUNC પ્રત્યેક\JJ વ્યક્તિ\N_NN આ\DM_DMD રીતે\N_NN જ\RP_RPD ,\RD_PUNC સ્વતંત્ર\JJ અને\CC_CCD સમાન\JJ હોવાનું\V_VAUX_VNP અનુભવે\V_VM છે\V_VAUX .\RD_PUNC
GJRED767	આમાં\DM_DMD દરેક\JJ જણ\N_NN પોતે\PR_PRF કરે\V_VM અને\CC_CCD પોતે\PR_PRF ભોગવે\V_VM .\RD_PUNC
GJRED768	પોતે\PR_PRF વાવે\V_VM અને\CC_CCD પોતે\PR_PRF લણે\V_VM .\RD_PUNC
GJRED769	બીજાની\JJ તેમાં\DM_DMD જવાબદારી\N_NN પણ\RP_RPD નહિ\RP_NEG અને\CC_CCD ભાગીદારી\N_NN પણ\RP_RPD નહિ\RP_NEG .\RD_PUNC
GJRED770	આમ\PSP છતાં\RP_RPD ,\RD_PUNC જે\PR_PRL તે\PR_PRL વ્યક્તિ\N_NN `\RD_PUNC સામાજિક\JJ પ્રાણી\N_NN `\RD_PUNC હોવાને\V_VAUX_VNP પોતાનો\PR_PRF દરજ્જો\N_NN ગુમાવતી\V_VAUX_VNP નથી\RP_NEG કે\CC_CCS અન્ય\JJ નિરપેક્ષ\JJ ,\RD_PUNC બેજવાબદાર\JJ કે\CC_CCS સ્વચ્છંદ\JJ થઈ\V_VM જાય\V_VAUX છે\V_VAUX એવું\JJ નથી\RP_NEG .\RD_PUNC
GJRED771	જૈનશાસન\N_NN ,\RD_PUNC લોકશાહીની\N_NN આ\DM_DMD જ\RP_RPD વિભાવનાને\N_NN કેન્દ્રમાં\N_NN રાખીને\V_VAUX_VNP કર્મના\N_NN નિયમને\N_NN સર્વોચ્ચ\JJ અગત્ય\N_NN આપે\V_VM છે\V_VAUX .\RD_PUNC
GJRED772	પ્રત્યેક\JJ `\RD_PUNC આત્મા\N_NN `\RD_PUNC `\RD_PUNC સ્વતંત્ર\JJ `\RD_PUNC છે\V_VAUX અને\CC_CCD `\RD_PUNC સમાન\JJ `\RD_PUNC પણ\RP_RPD .\RD_PUNC
GJRED773	ભૌતિક\JJ સંદર્ભમાં\N_NN જે\PR_PRL ધોરણો\N_NN પ્રત્યેક\JJ આત્માને\N_NN ,\RD_PUNC અર્થાત્\PSP સમગ્ર\JJ જીવજગતને\N_NN લાગુ\JJ પડે\V_VM છે\V_VAUX .\RD_PUNC
GJRED774	લોકશાહીમાં\N_NNP જેમ\PSP `\RD_PUNC કાયદાનું\N_NN `\RD_PUNC જ\RP_RPD માત્ર\RP_RPD શાસન\N_NN છે\V_VAUX ,\RD_PUNC તેમ\PSP આત્મિક\JJ લોકશાહીમાં\N_NN `\RD_PUNC કર્મનું\N_NN `\RD_PUNC જ\RP_RPD માત્ર\RP_RPD શાસન\N_NN છે\V_VAUX .\RD_PUNC
GJRED775	ખરેખર\PSP તો\RP_RPD કર્મની\N_NN સર્વોપરિતાનો\N_NN સ્વીકાર\N_NN કરી\V_VM લઈએ\V_VAUX ,\RD_PUNC તો\CC_CCD આત્મા\N_NN સ્વતંત્ર\JJ રહે\V_VM છે\V_VAUX .\RD_PUNC
GJRED776	તેની\PR_PRP સમાનતા\N_NN અબાધિત\JJ રહે\V_VM છે\V_VAUX .\RD_PUNC
GJRED777	પોતાનું\PR_PRF કર્તૃત્વ\N_NN કે\CC_CCS દાયિત્વ\N_NN કોઈ\PR_PRI અન્યના\JJ શિરે\N_NN થોપી\V_VM દેવો\V_VAUX_VNP તે\DM_DMD પલાયનવાદ\N_NN છે\V_VAUX .\RD_PUNC
GJRED778	અને\CC_CCD આ\DM_DMD સ્થિતિમાં\N_NN અકર્મણ્યતા\N_NN તો\RP_RPD ઊભી\V_VM જ\RP_RPD શાની\PR_PRQ રહે\V_VAUX ?\RD_PUNC
GJRED779	વાત\N_NN રહી\V_VM માત્ર\RP_RPD રૂક્ષતાની\N_NN .\RD_PUNC
GJRED780	એનો\DM_DMD જવાબ\N_NN આ\DM_DMD છે\V_VAUX :\RD_PUNC કર્મસત્તાના\N_NN કાનૂન\N_NN પ્રમાણે\PSP વર્તનારો\V_VAUX_VNP કે\CC_CCS જીવનારો\V_VAUX_VNP આત્મા\N_NN અને\CC_CCD તેનું\DM_DMD આચરણ\N_NN રૂક્ષ\JJ ,\RD_PUNC નીરસ\JJ અને\CC_CCD આનંદ\N_NN કે\CC_CCS પ્રેમથી\N_NN ભીરુ\JJ બની\V_VM જાય\V_VAUX છે\V_VAUX .\RD_PUNC
GJRED781	જૈન\N_NNP ધર્મના\N_NNP કર્મસિદ્ધાંતના\N_NN આધારે\N_NN ,\RD_PUNC પ્રત્યેક\JJ આત્મા\N_NN જ\RP_RPD કાળાંતરે\N_NN પરમાત્મા\N_NN બને\V_VM છે\V_VAUX .\RD_PUNC
GJRED782	શુદ્ધ\JJ ચૈતન્યરૂપ\N_NN એ\DM_DMD પરમ\JJ -\RD_PUNC આત્માને\N_NN આપણે\PR_PRP પરમ\JJ સત્તા\N_NN અથવા\CC_CCD ભગવાન\N_NN તરીકે\PSP ઓળખીએ\V_VM છીએ\V_VAUX .\RD_PUNC
GJRED783	શાંત\JJ હૈયે\N_NN વિમર્શ\N_NN કરનાર\V_VAUX_VNP શાણા\JJ આદમીને\N_NN ,\RD_PUNC આ\DM_DMD રીતે\N_NN વિચારધારા\N_NN કેળવવાથી\V_VAUX_VNP ,\RD_PUNC કર્મના\N_NN નિયમનો\N_NN પરમાર્થ\N_NN પકડાયા\V_VM વિના\PSP નહિ\RP_NEG રહે\V_VAUX .\RD_PUNC
GJRED784	અને\CC_CCD પછી\PSP જુદી\JJ જુદી\JJ વિચારધારાઓમાં\N_NN પણ\RP_RPD કેવું\DM_DMQ સામરસ્ય\N_NN છે\V_VAUX તેનો\PR_PRP સંકેત\N_NN સાંપડ્યા\V_VAUX_VNP વિના\PSP નહિ\RP_NEG રહે\V_VAUX .\RD_PUNC
GJRED785	સંસાર\N_NN એટલે\PSP ક્લેશ\N_NN .\RD_PUNC
GJRED786	જ્યાં\N_NST ક્લેશ\N_NN નથી\RP_NEG ત્યાં\N_NST સંસાર\N_NN નથી\RP_NEG હોતો\V_VAUX .\RD_PUNC
GJRED787	નમક\N_NN વિના\PSP જેમ\PSP રસોઈ\N_NN અલૂણી\JJ .\RD_PUNC
GJRED788	તેમ\PSP ક્લેશવિહોણો\JJ સંસાર\N_NN પણ\RP_RPD અલૂણો\JJ ,\RD_PUNC નિષ્પ્રાણ\JJ ,\RD_PUNC વ્યર્થ\JJ બની\V_VM રહે\V_VAUX .\RD_PUNC
GJRED789	ઉપાધ્યાયજી\N_NNP મહારાજે\N_NNP તેથી\PSP જ\RP_RPD કહ્યું\V_VM :\RD_PUNC `\RD_PUNC ક્લેશરહિત\JJ મન\N_NN તે\DM_DMD ભવ\N_NN -\RD_PUNC પાર\N_NN .\RD_PUNC `\RD_PUNC
GJRED790	આ\DM_DMD ક્લેશનું\N_NN કારણ\N_NN શું\PR_PRQ ?\RD_PUNC
GJRED791	કલેશનાં\N_NN બે\QT_QTC કારણ\N_NN છે\V_VAUX :\RD_PUNC અહં\N_NN અને\CC_CCD ઈચ્છા\N_NN .\RD_PUNC
GJRED792	આ\DM_DMD બે\QT_QTC ય\RP_RPD વાનાં\N_NN સાધનાપથમાં\N_NN ,\RD_PUNC આત્મશુદ્ધિની\N_NN આડે\PSP આવનારાં\V_VAUX_VNP ,\RD_PUNC નડનારાં\V_VAUX_VNP નડતર\N_NN છે\V_VAUX .\RD_PUNC
GJRED793	બેમાંથી\QT_QTC કોઈ\DM_DMI એકને\QT_QTC નાબૂદ\JJ કરવાથી\V_VAUX_VNP કામ\N_NN ન\RP_NEG ચાલે\V_VM .\RD_PUNC
GJRED794	બન્નેનો\JJ નિકાલ\N_NN થવો\V_VAUX_VNP જોઈએ\V_VAUX .\RD_PUNC
GJRED795	ધારો\V_VM કે\CC_CCS કોઈ\DM_DMI એક\QT_QTC કામ\N_NN કરવાની\V_VAUX_VNP આપણને\PR_PRP ઈચ્છા\N_NN થઈ\V_VM .\RD_PUNC
GJRED796	ઈચ્છા\N_NN એટલા\JJ માટે\PSP થઈ\V_VM કે\CC_CCS એ\DM_DMD કામ\N_NN કરીશ\V_VM તો\CC_CCD મારું\PR_PRP નામ\N_NN થશે\V_VM ,\RD_PUNC સારું\JJ લાગશે\V_VM અને\CC_CCD બોલાશે\V_VM .\RD_PUNC
GJRED797	આ\DM_DMD પ્રકારના\N_NN અહંભાવમાંથી\N_NN ઈચ્છા\N_NN પેદા\JJ થઈ\V_VM .\RD_PUNC
GJRED798	એને\DM_DMD પાર\N_NN પાડવા\V_VAUX_VNP માટે\PSP પછી\PSP અનેક\JJ જાતનાં\N_NN આયોજનો\N_NN વિચાર્યા\V_VM .\RD_PUNC
GJRED799	હવે\N_NST બને\V_VM એવું\JJ કે\CC_CCS તે\DM_DMD જ\RP_RPD પળે\N_NN આપણને\PR_PRP ખબર\N_NN મળે\V_VM કે\CC_CCS એ\DM_DMD કામ\N_NN તો\RP_RPD બીજાએ\JJ કરી\V_VM વાળ્યું\V_VM છે\V_VAUX કે\CC_CCS કરવા\V_VAUX_VNP માંડ્યું\V_VM છે\V_VAUX !\RD_PUNC
GJRED800	એ\DM_DMD વેળા\N_NN આપણી\PR_PRP દશા\N_NN કેવી\DM_DMQ થાય\V_VM !\RD_PUNC
GJRED801	જાણે\PSP હાથમાં\N_NN આવેલો\V_VAUX_VNP કોળિયો\N_NN કોઈએ\PR_PRI ઝૂંટવી\V_VAUX_VNP લીધો\V_VM હોય\V_VAUX એવી\JJ લાગણી\N_NN થાય\V_VM ને\RP_RPD ?\RD_PUNC
GJRED802	ક્રોધ\N_NN ,\RD_PUNC દ્વેષ\N_NN ,\RD_PUNC હતાશા\N_NN ,\RD_PUNC વ્યાકુળતા\N_NN વગેરે\PSP ભાવો\N_NN પેદા\JJ થાય\V_VM ને\RP_RPD ?\RD_PUNC
GJRED803	સંસાર\N_NN સાવ\PSP જૂઠો\JJ ,\RD_PUNC નકામો\JJ ,\RD_PUNC નગુણો\JJ હોવાનું\V_VAUX_VNP ભાસવા\V_VAUX_VNP માંડે\V_VM ને\RP_RPD ?\RD_PUNC
GJRED804	ઈચ્છા\N_NN જોખમાય\V_VM ત્યારે\N_NST અને\CC_CCD અહં\N_NN ઘવાય\V_VM ત્યારે\N_NST આવો\JJ ક્લેશ\N_NN અવશ્ય\JJ થાય\V_VM જ\RP_RPD ,\RD_PUNC અને\CC_CCD આનું\DM_DMD જ\RP_RPD નામ\N_NN તો\RP_RPD સંસાર\N_NN !\RD_PUNC
GJRED805	આ\DM_DMD સંસારથી\N_NN બચવાની\V_VAUX_VNP તત્પરતા\N_NN -\RD_PUNC જાગૃતિ\N_NN કેળવે\V_VM તેનું\DM_DMD નામ\N_NN સાધક\N_NN .\RD_PUNC
GJRED806	પોતાની\PR_PRF ઈચ્છા\N_NN પ્રમાણે\PSP ન\RP_NEG થાય\V_VM ,\RD_PUNC વિપરીત\JJ થાય\V_VM ,\RD_PUNC ઈચ્છા\N_NN અધૂરી\JJ રહી\V_VM જાય\V_VAUX ;\RD_PUNC બીજાઓની\JJ અયોગ્ય\JJ ઈચ્છા\N_NN પ્રમાણે\PSP થાય\V_VM અને\CC_CCD આપણી\PR_PRP યોગ્ય\JJ ઈચ્છાઓ\N_NN પણ\RP_RPD રહી\V_VM જાય\V_VAUX .\RD_PUNC
GJRED807	જ્ઞાની\JJ ભગવંતે\N_NNP દીઠું\V_VM હોય\V_VAUX તેમ\PSP જ\RP_RPD બને\V_VM -\RD_PUNC આવી\JJ સમજણ\N_NN કેળવાય\V_VM તેટલી\JJ તે\DM_DMD જ\RP_RPD આત્માની\N_NN અને\CC_CCD શાસનની\N_NN -\RD_PUNC ધર્મની\N_NN -\RD_PUNC અધ્યાત્મની\N_NN સાધના\N_NN કરી\V_VM શકે\V_VAUX .\RD_PUNC
GJRED808	વિચારશીલ\JJ માણસ\N_NN એમ\PSP પણ\RP_RPD વિચારે\V_VM કે\CC_CCS જે\PR_PRL લોકો\N_NN સ્થાપના\N_NN -\RD_PUNC નિક્ષેપામાં\N_NN એટલે\PSP મૂર્તિમાં\N_NN નથી\RP_NEG માનતા\V_VAUX_VNP તેવા\JJ સંપ્રદાયના\N_NN લોકો\N_NN પણ\RP_RPD હવે\N_NST તો\RP_CL ભગવાનમાં\N_NN આગમસૂત્રોને\N_NN સરસ\JJ ચિત્રો\N_NN સાથે\PSP છપાવવા\V_VAUX_VNP માંડ્યા\V_VM છે\V_VAUX .\RD_PUNC
GJRED809	આપણે\PR_PRP ત્યાં\N_NST બધી\QT_QTF જ\RP_RPD ક્ષમતાઓ\N_NN તથા\CC_CCD ધન\N_NN ,\RD_PUNC માત્ર\RP_RPD કંકોત્રીઓની\N_NN નવનવી\JJ ડિઝાઈનો\N_NN માટે\PSP જ\RP_RPD વપરાય\V_VM છે\V_VAUX .\RD_PUNC
GJRED810	શું\PR_PRQ આ\DM_DMD ધન\N_NN તથા\CC_CCD શક્તિનો\N_NN સદુપયોગ\N_NN આગમો\N_NN તથા\CC_CCD શાસ્ત્રોના\N_NN સુંદર\JJ અલંકૃત\JJ પ્રકાશનાદિ\N_NN માટે\PSP ન\RP_NEG થઈ\V_VM શકે\V_VAUX ?\RD_PUNC
GJRED811	ગુજરાતમાં\N_NNP વીસનગર\N_NNP નજીક\JJ ઉમતા\N_NNP ગામમાં\N_NNP સેંકડો\RB જિનબિંબો\N_NN સાથેનું\PSP પ્રાચીન\JJ જિનાલય\N_NN ધરતીમાંથી\N_NN નીકળ્યું\V_VM છે\V_VAUX .\RD_PUNC
GJRED812	તેમાં\DM_DMD દિગંબર\N_NNP -\RD_PUNC શ્વેતાબંર\N_NNP બન્ને\JJ સંપ્રદાયનો\N_NN સંબંધ\N_NN જોડાયેલો\V_VAUX_VNP છે\V_VAUX .\RD_PUNC
GJRED813	કરોડોના\N_NN ખર્ચે\N_NN નવાંનવાં\JJ તીર્થોનાં\N_NN નિર્માણ\N_NN કરનારા\V_VAUX_VNP -\RD_PUNC આપણા\PR_PRP કોઈ\PR_PRI શક્તિસંપન્ન\JJ મહાત્માનું\N_NN ધ્યાન\N_NN આ\DM_DMD દિશામાં\N_NN હજી\N_NST સુધી\PSP કેમ\DM_DMQ જતું\V_VAUX_VNP નથી\RP_NEG ?\RD_PUNC
GJRED814	તીર્થોમાં\N_NN કેસ\N_NN -\RD_PUNC ક્લેશો\N_NN ચાલે\V_VM છે\V_VAUX .\RD_PUNC
GJRED815	ત્યારે\N_NST આ\DM_DMD તો\RP_RPD ઘરને\N_NN આંગણે\N_NN રસ\N_NN લેવા\V_VAUX_VNP લાયક\JJ તીર્થ\N_NN જડ્યું\V_VM છે\V_VAUX .\RD_PUNC
GJRED816	આપણી\PR_PRP બેદરકારીનો\N_NN પૂરો\JJ લાભ\N_NN દિગંબર\N_NNP પક્ષે\N_NNP ઊઠાવી\V_VAUX_VNP લીધો\V_VM છે\V_VAUX .\RD_PUNC
GJRED817	સરકારી\JJ ગ્રાન્ટ\N_NN સહિત\JJ બધું\QT_QTF જ\RP_RPD તે\DM_DMD પક્ષ\N_NN વગે\V_VM કર્યે\V_VAUX_VNP જાય\V_VAUX છે\V_VAUX .\RD_PUNC
GJRED818	૨૫\QT_QTC -\RD_PUNC ૫૦\QT_QTC કરોડ\N_NN ખર્ચાવી\V_VAUX_VNP જાણનાર\V_VAUX_VNP લોકો\N_NN આવી\JJ ઐતિહાસિક\JJ વાતે\N_NN તદ્દન\PSP અજ્ઞાન\JJ ,\RD_PUNC બેદરકાર\JJ ,\RD_PUNC ઉદાસ\JJ કેમ\DM_DMQ હશે\V_VAUX ?\RD_PUNC
GJRED819	હમણાં\N_NST વળી\PSP નવી\JJ ઘટનાઓ\N_NN શરૂ\JJ થઈ\V_VM છે\V_VAUX ,\RD_PUNC ચમત્કારોની\N_NN .\RD_PUNC
GJRED820	ક્યાંક\N_NST અમીઝરણાં\N_NN થાય\V_VM ,\RD_PUNC ક્યાંક\N_NST વળી\PSP કેસરના\N_NN છાંટણાં\N_NN પણ\RP_RPD થાય\V_VM .\RD_PUNC
GJRED821	પણ\CC_CCD આ\DM_DMD પરંપરાગત\JJ ચમત્કારો\N_NN હવે\N_NST જરા\QT_QTF જૂના\JJ જણાય\V_VM છે\V_VAUX .\RD_PUNC
GJRED822	હવે\N_NST તો\RP_RPD ધરણેન્દ્રદેવ\N_NNP અને\CC_CCD ક્ષેત્રપાળદેવ\N_NNP સાક્ષાત્\JJ હાજર\JJ થવા\V_VAUX_VNP માંડ્યા\V_VM છે\V_VAUX !\RD_PUNC
GJRED823	ક્યાંક\N_NST કોઈ\DM_DMI પણ\RP_RPD રૂપમાં\N_NN સર્પ\N_NN કે\CC_CCS નાગ\N_NN દેખાય\V_VM ,\RD_PUNC કે\CC_CCS થયું\V_VM :\RD_PUNC ક્ષેત્રપાળદાદા\N_NNP હાજરાહજૂર\JJ !\RD_PUNC
GJRED824	પછી\PSP દૂધના\N_NN વાટકા\N_NN ,\RD_PUNC શ્રીફળ\N_NN ,\RD_PUNC દીવા\N_NN ,\RD_PUNC સિંદૂર\N_NN અને\CC_CCD ભાતભાતની\JJ વાયકા\N_NN તથા\CC_CCD માન્યતાઓ\N_NN અને\CC_CCD લોકોનો\N_NN પ્રવાહ\N_NN !\RD_PUNC
GJRED825	ઇતિહાસમાં\N_NN ધરણેન્દ્રે\N_NNP આ\DM_DMD રીતે\N_NN પરચો\N_NN આપ્યો\V_VM હોવાનો\V_VAUX_VNP દાખલો\N_NN નથી\RP_NEG જડતો\V_VAUX_VNP .\RD_PUNC
GJRED826	આજે\N_NST તો\RP_RPD એ\DM_DMD દૈવી\JJ તત્ત્વો\N_NN પાસે\PSP જાણે\PSP આવા\JJ પરચા\N_NN આપવા\V_VAUX_VNP સિવાય\PSP કોઈ\DM_DMI કામ\N_NN જ\RP_RPD નથી\RP_NEG લાગતું\V_VAUX_VNP !\RD_PUNC
GJRED827	વિચારકો\N_NN તરત\PSP પૂછે\V_VM કે\CC_CCS આ\DM_DMD દેવો\N_NN આ\DM_DMD સ્વરૂપે\N_NN આવે\V_VM છે\V_VAUX એ\DM_DMD વાત\N_NN ઘડીભર\JJ સાચી\JJ માની\V_VM લેવા\V_VAUX_VNP અમે\PR_PRP તૈયાર\JJ છીએ\V_VAUX .\RD_PUNC
GJRED828	પણ\CC_CCD અમારે\PR_PRP એ\DM_DMD જાણવું\V_VAUX_VNP છે\V_VAUX કે\CC_CCS આ\DM_DMD રીતે\N_NN એમના\DM_DMD આવવાથી\V_VAUX_VNP સંઘને\N_NN કે\CC_CCS જૈન\N_NNP શાસનને\N_NNP શો\DM_DMQ લાભ\N_NN ?\RD_PUNC
GJRED829	સંઘના\N_NN કોઈ\DM_DMI પ્રશ્નો\N_NN હલ\JJ થાય\V_VM ખરા\RP_RPD ?\RD_PUNC
GJRED830	તીર્થોના\N_NN વિખવાદોને\N_NN શમાવી\V_VM દે\V_VAUX ખરા\RP_RPD ?\RD_PUNC
GJRED831	શાસનની\N_NN અઢળક\JJ સમસ્યાઓ\N_NN છે\V_VAUX .\RD_PUNC
GJRED832	બાકી\PSP `\RD_PUNC સંતોષીમાની\N_NNP `\RD_PUNC રોટલી\N_NN કે\CC_CCS પોસ્ટકાર્ડ\N_NN લખવા\V_VAUX_VNP જેવા\JJ પરચાથી\N_NN સંઘને\N_NN શો\DM_DMQ લાભ\N_NN ?\RD_PUNC
GJRED833	સિવાય\PSP કે\CC_CCS અંધશ્રદ્ધા\N_NN વધારવાની\V_VAUX_VNP અને\CC_CCD ચોક્કસ\JJ હિત\N_NN -\RD_PUNC હેતુ\N_NN ધરાવતા\V_VAUX_VNP લોકોની\N_NN પ્રવૃત્તિને\N_NN પોષતાં\V_VAUX_VNP રહેવાનું\V_VAUX_VNP !\RD_PUNC
GJRED834	જૈન\N_NNP ધર્મ\N_NNP એ\DM_DMD તાત્ત્વિક\JJ ધર્મ\N_NN છે\V_VAUX .\RD_PUNC
GJRED835	બુદ્ધિગમ્ય\JJ ધર્મ\N_NN છે\V_VAUX .\RD_PUNC
GJRED836	તેને\DM_DMD ,\RD_PUNC તેના\DM_DMD રહસ્યમય\JJ સિદ્ધાંતોને\N_NN સમજવા\V_VAUX_VNP -\RD_PUNC સમજાવવા\V_VAUX_VNP અત્યંત\JJ આવશ્યક\JJ છે\V_VAUX .\RD_PUNC
GJRED837	આપણે\PR_PRP બધા\QT_QTF બિનજરૂરી\JJ ખ્યાલો\N_NN અને\CC_CCD ભ્રમણાઓમાંથી\N_NN બહાર\N_NST આવીશું\V_VM તોજ\RP_RPD આ\DM_DMD આવશ્યક્તા\N_NN આપણા\PR_PRP ગળે\N_NN ઊતરી\V_VM શકશે\V_VAUX .\RD_PUNC
GJRED838	હમણાં\N_NST તો\RP_RPD વર્લ્ડ\N_NN કપ\N_NN ફીવર\N_NN ચાલતો\V_VAUX_VNP હતો\N_NST .\RD_PUNC
GJRED839	આ\DM_DMD આપણા\PR_PRP નૈતિક\JJ અધ:પતનની\N_NN નિશાની\N_NN છે\V_VAUX .\RD_PUNC
GJRED840	વર્લ્ડ\N_NN કપમાં\N_NN ભારત\N_NNP ન\RP_NEG જીત્યું\V_VM અથવા\CC_CCD હાર્યું\V_VM ,\RD_PUNC તેનો\DM_DMD આઘાત\N_NN સૌને\JJ છે\V_VAUX .\RD_PUNC
GJRED841	પણ\CC_CCD આ\DM_DMD યુદ્ધમાં\N_NN હજારો\N_NN મનુષ્યોનું\N_NN નિકંદન\N_NN નીકળી\V_VM રહ્યાં\V_VAUX છે\V_VAUX તેના\DM_DMD અંગે\PSP કોઈની\PR_PRI ય\RP_RPD સંવેદના\N_NN ઘવાઈ\V_VM હશે\V_VAUX ખરી\RP_RPD ?\RD_PUNC
GJRED842	શક્યતા\N_NN ઓછી\QT_QTF છે\V_VAUX .\RD_PUNC
GJRED843	આપણે\PR_PRP ધર્મના\N_NN વાસ્તવિક\N_NN તત્ત્વને\N_NN સમજ્યા\V_VM જ\RP_RPD નથી\RP_NEG .\RD_PUNC
GJRED844	સ્વાર્થ\N_NN બે\QT_QTC વ્યક્તિઓ\N_NN વચ્ચેનો\N_NST હોય\V_VAUX તોય\RP_RPD તેનો\DM_DMD અંજામ\N_NN તો\RP_RPD પાયમાલીમાં\N_NN જ\RP_RPD આવવાનો\V_VAUX_VNP .\RD_PUNC
GJRED845	સ્વાર્થ\N_NN માટે\PSP બીજાનો\JJ ભોગ\N_NN લઈ\V_VM શકાય\V_VAUX .\RD_PUNC
GJRED846	સ્વાર્થ\N_NN માટે\PSP બીજાનો\JJ ગેરલાભ\N_NN ઊઠાવી\V_VM શકાય\V_VAUX .\RD_PUNC
GJRED847	સ્વાર્થ\N_NN તે\DM_DMD જેમાં\PR_PRL બીજાના\JJ હિતના\N_NN ભોગે\N_NN પોતાનું\PR_PRF હિત\N_NN સિદ્ધ\JJ થાય\V_VM .\RD_PUNC
GJRED848	આવો\JJ સ્વાર્થ\N_NN હોય\V_VAUX આપણા\PR_PRP મનમાં\N_NN ,\RD_PUNC ત્યાં\N_NST સુધી\PSP આપણામાં\PR_PRP સો\QT_QTC ટચની\N_NN ધાર્મિક્તા\N_NN પાંગરે\V_VM એ\DM_DMD વાતમાં\N_NN દમ\N_NN નહિ\RP_NEG .\RD_PUNC
GJRED849	જોકે\CC_CCS હવે\N_NST તો\RP_RPD ધર્મો\N_NN પણ\RP_RPD સ્વાર્થ\N_NN સાધવામાં\V_VAUX_VNP મંડ્યા\V_VM છે\V_VAUX .\RD_PUNC
GJRED850	અત્યારે\N_NST અમે\PR_PRP કર્ણાટક\N_NNP ,\RD_PUNC આંધ્ર\N_NNP ,\RD_PUNC તમિળનાડુ\N_NNP -\RD_PUNC આ\DM_DMD ત્રણ\QT_QTC પ્રાંતોના\N_NN વિસ્તારમાં\N_NN છીએ\V_VAUX .\RD_PUNC
GJRED851	દેખીતી\JJ રીતે\N_NN આ\DM_DMD માનવતા\N_NN કે\CC_CCS દયા\N_NN કે\CC_CCS પરોપકારની\N_NN પ્રવૃત્તિ\N_NN ગણાય\V_VM -\RD_PUNC લાગે\V_VM .\RD_PUNC
GJRED852	વગર\PSP પ્રયોજને\N_NN અને\CC_CCD વિના\PSP સ્વાર્થે\N_NN ,\RD_PUNC કોઈ\DM_DMI જ\RP_RPD વળતર\N_NN કે\CC_CCS સાનુકૂળ\JJ પ્રત્યાઘાતની\N_NN અપેક્ષા\N_NN રાખ્યા\V_VAUX_VNP વિના\PSP સામાને\JJ મદદ\N_NN કરીએ\V_VM તોજ\RP_RPD -\RD_PUNC તે\DM_DMD પરોપકાર\N_NN
GJRED853	આપણી\PR_PRP આ\DM_DMD ઉદારતાનો\N_NN પાકો\JJ ફાયદો\N_NN આ\DM_DMD મિશનરીઓ\N_NN ઊઠાવે\V_VM છે\V_VAUX .\RD_PUNC
GJRED854	અને\CC_CCD સ્વાર્થ\N_NN સાધવા\V_VAUX_VNP માટે\PSP ધર્મનો\N_NN પણ\RP_RPD ઉપયોગ\N_NN કરવામાં\V_VAUX_VNP અચકાતાં\V_VAUX_VNP નથી\RP_NEG .\RD_PUNC
GJRED855	આ\DM_DMD સ્વાર્થથી\N_NN આપણા\PR_PRP ધર્મની\N_NN ,\RD_PUNC સંસ્કૃતિની\N_NN તથા\CC_CCD સંસ્કારોની\N_NN પાયમાલી\N_NN જ\RP_RPD થઈ\V_VM રહી\V_VAUX છે\V_VAUX .\RD_PUNC
GJRED856	સ્વાર્થની\N_NN સામે\PSP મૂકી\V_VM શકાય\V_VAUX તેવું\JJ તત્ત્વ\N_NN છે\V_VAUX `\RD_PUNC પ્રેમ\N_NN `\RD_PUNC .\RD_PUNC
GJRED857	આ\DM_DMD એક\QT_QTC જ\RP_RPD તત્ત્વ\N_NN એવું\JJ છે\V_VAUX જે\PR_PRL ગમે\PSP તેવા\JJ સ્વાર્થને\N_NN કે\CC_CCS સ્વાર્થીને\JJ હંફાવે\V_VM છે\V_VAUX .\RD_PUNC
GJRED858	પ્રેમ\N_NN એટલે\PSP આપણી\PR_PRP ઈચ્છાઓને\N_NN ગૌણ\JJ બનાવવી\V_VAUX_VNP અને\CC_CCD આપણા\PR_PRP અહંનું\N_NN બલિદાન\N_NN આપી\V_VM દેવું\V_VAUX_VNP તે\DM_DMD .\RD_PUNC
GJRED859	જ્યાં\N_NST પ્રેમ\N_NN પાંગર્યો\V_VM હશે\V_VAUX ત્યાં\N_NST પોતાની\PR_PRF ઈચ્છા\N_NN કરતાં\V_VAUX_VNP પ્રીતિપાત્રની\JJ ઈચ્છાનું\N_NN મહત્ત્વ\N_NN વધુ\QT_QTF હશે\V_VAUX .\RD_PUNC
GJRED860	આવો\JJ નિર્મળ\JJ અને\CC_CCD ઉદાત્ત\JJ પ્રેમ\N_NN જ્યારે\N_NST ચિત્તમાં\N_NN પાંગરે\V_VM છે\V_VAUX ત્યારે\N_NST ત્યાં\N_NST સ્વાર્થની\N_NN દુર્ગંધનો\N_NN અંશ\N_NN પણ\RP_RPD રહેતો\V_VAUX_VNP નથી\RP_NEG .\RD_PUNC
GJRED861	ત્યાં\N_NST તો\RP_RPD હોય\V_VAUX છે\V_VAUX માત્ર\RP_RPD પરમાર્થની\N_NN ,\RD_PUNC બીજાના\JJ કલ્યાણની\N_NN વાસના\N_NN .\RD_PUNC
GJRED862	નુકસાનીનું\N_NN ત્યાં\N_NST નામ\N_NN ન\RP_NEG હોય\V_VAUX .\RD_PUNC
GJRED863	અને\CC_CCD આવી\JJ સ્વાર્થવિહોણી\JJ સ્થિતિ\N_NN હોય\V_VAUX ત્યાં\N_NST ધર્મ\N_NN અને\CC_CCD ધાર્મિક્તા\N_NN પાંગર્યા\V_VAUX_VNP વિના\PSP કેમ\DM_DMQ રહે\V_VAUX ?\RD_PUNC
GJRED864	ધર્મ\N_NN એટલે\PSP શું\PR_PRQ ?\RD_PUNC
GJRED865	એ\DM_DMD મુદ્દા\N_NN પર\PSP ઘણી\QT_QTF ઘણી\QT_QTF મથામણ\N_NN ચાલતી\V_VAUX_VNP રહે\V_VAUX છે\V_VAUX .\RD_PUNC
GJRED866	હમણાં\N_NST એવું\JJ સ્ફુરે\V_VM છે\V_VAUX કે\CC_CCS જેનાથી\PR_PRL ,\RD_PUNC જે\PR_PRL કરવાથી\V_VAUX_VNP ,\RD_PUNC વૃત્તિઓનું\N_NN પરિવર્તન\N_NN થાય\V_VM તેનું\DM_DMD નામ\N_NN ધર્મ\N_NN .\RD_PUNC
GJRED867	મને\PR_PRP એ\DM_DMD અગણિત\JJ શુભ\JJ -\RD_PUNC અશુભ\JJ વૃત્તિઓનો\N_NN અખૂટ\JJ સ્રોત\N_NN છે\V_VAUX અને\CC_CCD ભંડાર\N_NN પણ\RP_RPD છે\V_VAUX .\RD_PUNC
GJRED868	પરંતુ\CC_CCD તેમાંથી\DM_DMD વધુમાં\QT_QTF વધુ\QT_QTF ઉપયોગ\N_NN તો\RP_RPD અશુભ\JJ અથવા\CC_CCD મલિન\JJ વૃત્તિઓનો\N_NN જ\RP_RPD થતો\V_VAUX_VNP રહે\V_VAUX છે\V_VAUX .\RD_PUNC
GJRED869	એ\DM_DMD અશુભ\JJ વૃત્તિઓનું\N_NN શમન\N_NN અથવા\CC_CCD નિવારણ\N_NN થાય\V_VM અને\CC_CCD શુભ\JJ વૃત્તિઓનું\N_NN અનાવરણ\N_NN થાય\V_VM ,\RD_PUNC તોજ\RP_RPD વૃત્તિ\N_NN -\RD_PUNC પરિવર્તન\N_NN થયું\V_VM ગણાય\V_VM .\RD_PUNC
GJRED870	પ્રવૃત્તિમાર્ગની\N_NN એક\QT_QTC ખૂબી\N_NN છે\V_VAUX કે\CC_CCS ,\RD_PUNC તેનો\DM_DMD છંદ\N_NN લાગ્યા\V_VAUX_VNP પછી\PSP મહદંશે\JJ વિચારવાની\V_VAUX_VNP શક્તિ\N_NN અને\CC_CCD તક\N_NN -\RD_PUNC બન્ને\JJ નહિવત\RP_NEG બચે\V_VM છે\V_VAUX .\RD_PUNC
GJRED871	પ્રવૃત્તિ\N_NN અને\CC_CCD પ્રવર્તક\N_NN (\RD_SYM પ્રવૃત્તિ\N_NN માટે\PSP પ્રેરનાર\V_VAUX_VNP )\RD_SYM -\RD_PUNC બન્નેનું\JJ લક્ષ્ય\N_NN પણ\RP_RPD આ\DM_DMD જ\RP_RPD હોય\V_VAUX છે\V_VAUX .\RD_PUNC
GJRED872	વિચારે\V_VM તો\CC_CCD આઘોપાછો\JJ થાય\V_VM ને\RP_RPD ?\RD_PUNC
GJRED873	તો\CC_CCD દલીલ\N_NN કે\CC_CCS સવાલ\N_NN કરે\V_VM ને\RP_RPD ?\RD_PUNC
GJRED874	એને\PR_PRP એવી\JJ તક\N_NN જ\RP_RPD ન\RP_NEG મળવી\V_VAUX_VNP જોઈએ\V_VAUX .\RD_PUNC
GJRED875	અને\CC_CCD તો\CC_CCD પછી\PSP એ\DM_DMD જેમ\PSP કહીએ\V_VM તેમ\PSP કરવાનો\V_VAUX_VNP જ\RP_RPD .\RD_PUNC
GJRED876	આ\DM_DMD સ્થિતિ\N_NN એવી\JJ છે\V_VAUX કે\CC_CCS ,\RD_PUNC એમાં\QT_QTF વૃત્તિઓનું\N_NN દમન\N_NN થશે\V_VM ,\RD_PUNC પણ\CC_CCD શમન\N_NN નહિ\RP_NEG થાય\V_VM .\RD_PUNC
GJRED877	વૃત્તિઓ\N_NN દબાશે\V_VM ખરી\RP_RPD ,\RD_PUNC પણ\CC_CCD નાબૂદ\JJ નહિ\RP_NEG થાય\V_VM ,\RD_PUNC બદલાશે\V_VM પણ\RP_RPD નહિ\RP_NEG .\RD_PUNC
GJRED878	અહીં\N_NST સવાલ\N_NN એટલો\JJ જ\RP_RPD આવે\V_VM કે\CC_CCS તો\DM_DMD એ\DM_DMD પ્રવૃત્તિને\N_NN ધર્મ\N_NN ગણાય\V_VM ખરી\RP_RPD ?\RD_PUNC
GJRED879	ધર્મની\N_NN કોઈ\DM_DMI પણ\RP_RPD પ્રવૃત્તિ\N_NN આખરે\JJ વૃત્તિઓના\N_NN પરિવર્તન\N_NN માટે\PSP જ\RP_RPD હોવી\V_VAUX_VNP જોઈએ\V_VAUX .\RD_PUNC
GJRED880	મને\PR_PRP હંમેશાં\PSP સવાલ\N_NN થાય\V_VM કે\CC_CCS ,\RD_PUNC આ\DM_DMD `\RD_PUNC સાચી\JJ ભક્તિ\N_NN `\RD_PUNC વળી\PSP શું\PR_PRQ હશે\V_VAUX ?\RD_PUNC
GJRED881	ભક્તિ\N_NN તો\RP_RPD ભક્તિ\N_NN જ\RP_RPD હોય\V_VAUX અને\CC_CCD સાચી\JJ જ\RP_RPD હોય\V_VAUX ,\RD_PUNC એને\DM_DMD માટે\PSP `\RD_PUNC સાચી\JJ `\RD_PUNC શબ્દનો\N_NN પ્રયોગ\N_NN શા\PR_PRQ માટે\PSP કરવો\V_VAUX_VNP પડે\V_VAUX ?\RD_PUNC
GJRED882	શું\PR_PRQ ભક્તિના\N_NN પણ\RP_RPD બે\QT_QTC પ્રકાર\N_NN હશે\V_VAUX ?\RD_PUNC
GJRED883	એટલે\PSP તે\DM_DMD બીજા\JJ પ્રકારથી\N_NN જુદી\JJ પાડવા\V_VAUX_VNP માટે\PSP `\RD_PUNC સાચી\JJ `\RD_PUNC એવું\JJ વિશેષણ\N_NN જોડ્યું\V_VM હશે\V_VAUX ?\RD_PUNC
GJRED884	તો\CC_CCD એ\DM_DMD બીજો\JJ પ્રકાર\N_NN કયો\DM_DMQ હોય\V_VAUX ?\RD_PUNC
GJRED885	સ્વાભાવિક\JJ રીતે\N_NN જ\RP_RPD સમજાય\V_VM કે\CC_CCS `\RD_PUNC ખોટી\JJ `\RD_PUNC ભક્તિથી\N_NN બચવા\V_VAUX_VNP અથવા\CC_CCD જુદી\JJ પાડવા\V_VAUX_VNP માટે\PSP જ\RP_RPD અહીં\N_NST `\RD_PUNC સાચી\JJ `\RD_PUNC એવું\JJ વિશેષણ\N_NN જોડ્યું\V_VM હશે\V_VAUX ?\RD_PUNC
GJRED886	સ્વાભાવિક\JJ રીતે\N_NN જ\RP_RPD સમજાય\V_VM કે\CC_CCS `\RD_PUNC ખોટી\JJ `\RD_PUNC ભક્તિથી\N_NN બચવા\V_VAUX_VNP અથવા\CC_CCD જુદી\JJ પાડવા\V_VAUX_VNP માટે\PSP જ\RP_RPD અહીં\N_NST `\RD_PUNC સાચી\JJ `\RD_PUNC એવું\JJ વિશેષણ\N_NN અપાયું\V_VM છે\V_VAUX .\RD_PUNC
GJRED887	અર્થાત્\PSP ભક્તિ\N_NN કાયમ\JJ સાચી\JJ જ\RP_RPD હોય\V_VAUX એવું\JJ નથી\RP_NEG .\RD_PUNC
GJRED888	કવચિત્\PSP એ\DM_DMD ખોટી\JJ પણ\RP_RPD હોઈ\V_VAUX શકે\V_VAUX .\RD_PUNC
GJRED889	સાચી\JJ ભક્તિ\N_NN થાય\V_VM તો\CC_CCD `\RD_PUNC સાહેબ\N_NN `\RD_PUNC રીઝે\V_VM જ\RP_RPD .\RD_PUNC
GJRED890	સાચી\JJ ભક્તિની\N_NN આ\DM_DMD એંધાણી\N_NN છે\V_VAUX ,\RD_PUNC અને\CC_CCD આ\DM_DMD એનું\DM_DMD પરિણામ\N_NN પણ\RP_RPD છે\V_VAUX .\RD_PUNC
GJRED891	આપણને\PR_PRP સ્નેહ\N_NN પણ\RP_RPD સાચો\JJ કરતાં\V_VAUX_VNP આવડતું\V_VAUX_VNP નથી\RP_NEG ,\RD_PUNC તો\CC_CCD ભક્તિ\N_NN સાચી\JJ શી\PR_PRQ રીતે\N_NN આવડે\V_VM ?\RD_PUNC
GJRED892	આપણા\PR_PRP સ્નેહમાં\N_NN પણ\RP_RPD સ્વાર્થ\N_NN ભર્યો\V_VM હોય\V_VAUX છે\V_VAUX .\RD_PUNC
GJRED893	લોલુપતા\N_NN ,\RD_PUNC લાલસા\N_NN ,\RD_PUNC અપેક્ષા\N_NN ,\RD_PUNC આસક્તિ\N_NN જેવાં\JJ તત્ત્વો\N_NN છલકાતાં\V_VAUX_VNP હોય\V_VAUX તેવા\JJ સ્નેહમાં\N_NN ક્ષુલ્લક\JJ સ્વાર્થ\N_NN સિવાય\PSP બીજું\JJ સંભવે\V_VM પણ\RP_RPD શું\PR_PRQ ?\RD_PUNC
GJRED894	સ્વાર્થમુક્ત\JJ અને\CC_CCD નિરપેક્ષ\JJ અને\CC_CCD કેવળ\PSP કલ્યાણકામનાથી\N_NN મહેકતો\V_VAUX_VNP સ્નેહ\N_NN એ\DM_DMD આ\DM_DMD સંસારની\N_NN ,\RD_PUNC કલ્પવૃક્ષ\N_NN જેવી\JJ ,\RD_PUNC દુર્લભ\JJ પણ\RP_RPD મહામૂલી\JJ જણસ\N_NN છે\V_VAUX .\RD_PUNC
GJRED895	આવો\JJ સ્નેહ\N_NN કરી\V_VM શકે\V_VAUX તે\QT_QTF જ\RP_RPD સાચી\JJ ભક્તિ\N_NN પણ\RP_RPD કરી\V_VM શકે\V_VAUX .\RD_PUNC
GJRED896	સ્નેહને\N_NN સાચુકલો\JJ બનતાં\V_VAUX_VNP રોકે\V_VM બે\QT_QTC વાનાં\N_NN :\RD_PUNC અપેક્ષા\N_NN અને\CC_CCD અભિમાન\N_NN .\RD_PUNC
GJRED897	ભક્તિને\N_NN સાચુકલી\JJ બનતાં\V_VAUX_VNP રોકે\V_VM બે\QT_QTC વાનાં\N_NN :\RD_PUNC વાસના\N_NN અને\CC_CCD ચંચળતા\N_NN .\RD_PUNC
GJRED898	આજકાલ\N_NST સર્વત્ર\JJ રોગચાળાનું\N_NN અને\CC_CCD અનેક\JJ જાતના\N_NN ઉપદ્રવોનું\N_NN સામ્રાજ્ય\N_NN ફેલાયું\V_VM છે\V_VAUX .\RD_PUNC
GJRED899	બધા\QT_QTF જ\RP_RPD દુ:ખગ્રસ્ત\JJ છે\V_VAUX .\RD_PUNC
GJRED900	બધા\QT_QTF જ\RP_RPD અશાંત\JJ છે\V_VAUX .\RD_PUNC
GJRED901	બધે\QT_QTF જ\RP_RPD ઉદ્વેગ\N_NN અને\CC_CCD `\RD_PUNC કાલે\N_NST શું\PR_PRQ થશે\V_VM ?\RD_PUNC `\RD_PUNC તેની\DM_DMD દહેશત\N_NN છવાયેલ\V_VAUX_VNP છે\V_VAUX .\RD_PUNC
GJRED902	તો\CC_CCD અનુભવીઓ\N_NN એવું\JJ કહે\V_VM છે\V_VAUX કે\CC_CCS ,\RD_PUNC આવનારા\V_VAUX_VNP દિવસો\N_NN ,\RD_PUNC વીતેલા\V_VAUX_VNP દિવસો\N_NN કરતાં\V_VAUX_VNP કપરા\JJ હશે\V_VAUX .\RD_PUNC
GJRED903	જાણકારો\N_NN પણ\RP_RPD આમાં\DM_DMD સૂર\N_NN પૂરાવતા\V_VAUX_VNP રહે\V_VM છે\V_VAUX .\RD_PUNC
GJRED904	સહેજે\JJ સવાલ\N_NN થાય\V_VM કે\CC_CCS આ\DM_DMD દિવસો\N_NN આપણા\PR_PRP કેવા\DM_DMQ જશે\V_VM ?\RD_PUNC
GJRED905	અથવા\CC_CCD આપણું\PR_PRP શું\PR_PRQ થશે\V_VM ?\RD_PUNC
GJRED906	આનો\DM_DMD એક\QT_QTC જ\RP_RPD જવાબ\N_NN જડે\V_VM છે\V_VAUX ,\RD_PUNC ધર્મ\N_NN -\RD_PUNC આરાધનાનું\N_NN બળ\N_NN વધારો\V_VM .\RD_PUNC
GJRED907	તપ\N_NN ,\RD_PUNC જપ\N_NN અને\CC_CCD ધર્મકરણી\N_NN જેમ\PSP જેમ\PSP વધારે\QT_QTF થશે\V_VAUX ,\RD_PUNC તેમ\PSP તેમ\PSP આરાધનાનું\N_NN બળ\N_NN વધશે\V_VM .\RD_PUNC
GJRED908	અને\CC_CCD આરાધનાના\N_NN બળે\N_NN જ\RP_RPD ઉપદ્રવો\N_NN અને\CC_CCD દુ:ખ\N_NN -\RD_PUNC કષ્ટો\N_NN શાંત\JJ થશે\V_VM અથવા\CC_CCD હળવાં\JJ પડશે\V_VM .\RD_PUNC
GJRED909	સંસારી\JJ જીવો\N_NN પાસે\PSP જ્યારે\N_NST બીજી\JJ કોઈ\DM_DMI તાકાત\N_NN કે\CC_CCS બચાવ\N_NN બચતાં\V_VAUX_VNP નથી\RP_NEG ,\RD_PUNC ત્યારે\N_NST ધર્મઆરાધના\N_NN એ\DM_DMD એક\QT_QTC જ\RP_RPD તાકાત\N_NN એને\DM_DMD બચાવી\V_VM શકે\V_VAUX તેમ\PSP છે\V_VAUX .\RD_PUNC
GJRED910	તેમાં\DM_DMD ય\RP_RPD જો\CC_CCD તપ\N_NN -\RD_PUNC જપ\N_NN સામૂહિકરૂપે\JJ કરવામાં\V_VAUX_VNP આવે\V_VAUX તો\CC_CCD તેની\DM_DMD અસર\N_NN વાતાવરણ\N_NN પર\PSP બહુ\QT_QTF ઘેરી\JJ અને\CC_CCD બહુ\QT_QTF વ્યાપક\JJ પડતી\V_VAUX_VNP હોય\V_VAUX છે\V_VAUX .\RD_PUNC
GJRED911	એ\DM_DMD અસર\N_NN આખા\JJ રાષ્ટ્રને\N_NN ,\RD_PUNC રાજ્યને\N_NN ,\RD_PUNC નગરને\N_NN તેમજ\CC_CCD સમાજને\N_NN અનેકવિધ\JJ તકલીફો\N_NN તથા\CC_CCD પ્રકોપથી\N_NN ઉગારી\V_VM શકે\V_VAUX છે\V_VAUX .\RD_PUNC
GJRED912	જગતના\N_NN દરેક\JJ ધર્મ\N_NN અને\CC_CCD સંપ્રદાયના\N_NN લોકો\N_NN પોતાના\PR_PRF અધિકારો\N_NN માટે\PSP લડે\V_VM છે\V_VAUX .\RD_PUNC
GJRED913	પોતાની\PR_PRF સત્તા\N_NN તથા\CC_CCD લાગવગ\N_NN કે\CC_CCS પહોંચ\N_NN વધારવા\V_VAUX_VNP માટે\PSP કટિબદ્ધ\JJ જોવા\V_VAUX_VNP મળે\V_VM છે\V_VAUX .\RD_PUNC
GJRED914	તો\CC_CCD અમુક\PSP અમુક\PSP ધર્મો\N_NN તો\RP_RPD પોતાના\PR_PRF અનુયાયીઓની\N_NN સંખ્યા\N_NN કેમ\DM_DMQ વધે\V_VM ,\RD_PUNC બીજા\JJ બધા\QT_QTF ધર્મોને\N_NN છોડીને\V_VAUX_VNP પોતાના\PR_PRF ધર્મમાં\N_NN જ\RP_RPD કેમ\DM_DMQ વધુ\QT_QTF માણસો\N_NN દાખલ\JJ થાય\V_VM ,\RD_PUNC તેની\DM_DMD જ\RP_RPD ફિરાકમાં\N_NN હોય\V_VAUX છે\V_VAUX .\RD_PUNC
GJRED915	પ્રલોભનો\N_NN દ્વારા\PSP ,\RD_PUNC છેતરપિંડી\N_NN દ્વારા\PSP અને\CC_CCD છેવટે\JJ ધાકધમકી\N_NN કે\CC_CCS બળજબરીથી\N_NN અન્ય\JJ ધર્મવાળાઓને\JJ વટલાવવા\V_VAUX_VNP અને\CC_CCD પોતાના\PR_PRF ધર્માનુયાયી\N_NN બનાવવા\V_VAUX_VNP ,\RD_PUNC એ\DM_DMD આવા\JJ લોકોનું\N_NN મિશન\N_NN અથવા\CC_CCD લક્ષ્યાંક\N_NN હોય\V_VAUX છે\V_VAUX .\RD_PUNC
GJRED916	વાત\N_NN પણ\RP_RPD સાચી\JJ છે\V_VAUX .\RD_PUNC
GJRED917	જેમના\PR_PRL ધર્મમાં\N_NN આત્મા\N_NN નામની\N_NN ચીજનું\N_NN કોઈ\DM_DMI અસ્તિત્વ\N_NN ન\RP_NEG હોય\V_VAUX ,\RD_PUNC પરલોક\N_NN અર્થાત્\PSP મોક્ષ\N_NN જેવી\JJ કોઈ\DM_DMI સ્થિતિનો\N_NN સ્વીકાર\N_NN જ\RP_RPD ન\RP_NEG હોય\V_VAUX .\RD_PUNC
GJRED918	જેમ\PSP જેમ\PSP સમય\N_NN વીતતો\V_VAUX_VNP જાય\V_VM છે\V_VAUX તેમ\PSP તેમ\PSP અનુભવ\N_NN વધતો\V_VAUX_VNP જાય\V_VM છે\V_VAUX .\RD_PUNC
GJRED919	આ\DM_DMD અનુભવ\N_NN એક\QT_QTC વાત\N_NN શીખવે\V_VM છે\V_VAUX કે\CC_CCS જે\PR_PRL કરવાથી\V_VAUX_VNP અહં\N_NN અને\CC_CCD મમત્વ\N_NN અને\CC_CCD એષણા\N_NN વધતાં\V_VAUX_VNP હોય\V_VAUX તેને\DM_DMD કદાપિ\PSP `\RD_PUNC ધર્મ\N_NN `\RD_PUNC ગણાય\V_VM નહિ\RP_NEG .\RD_PUNC
GJRED920	ધર્મ\N_NN ક્યારેક\N_NST ક્રિયારૂપ\N_NN હોય\V_VAUX ,\RD_PUNC કદીક\PSP જ્ઞાન\N_NN રૂપે\N_NN હોય\V_VAUX કે\CC_CCS કવચિત્\JJ તપ\N_NN -\RD_PUNC સ્વરૂપે\N_NN હોય\V_VAUX .\RD_PUNC
GJRED921	કોઈ\DM_DMI પણ\RP_RPD પ્રકારની\N_NN આ\DM_DMD ધર્મકરણી\N_NN કરવાથી\V_VAUX_VNP જો\CC_CCD અહંકાર\N_NN વધતો\V_VAUX_VNP હોય\V_VAUX ,\RD_PUNC મમત્વ\N_NN પોષાતું\V_VAUX_VNP હોય\V_VAUX અને\CC_CCD ઈચ્છાઓ\N_NN જો\CC_CCD વકરતી\V_VAUX_VNP હોય\V_VAUX તો\CC_CCD તે\DM_DMD ક્રિયા\N_NN ,\RD_PUNC જ્ઞાન\N_NN કે\CC_CCS તપ\N_NN ,\RD_PUNC `\RD_PUNC ધર્મ\N_NN `\RD_PUNC તરીકે\N_NN લોકરૂઢિએ\N_NN ગવાતાં\V_VAUX_VNP હોવા\V_VAUX_VNP છતાં\RP_RPD ,\RD_PUNC `\RD_PUNC ધર્મ\N_NN `\RD_PUNC ગણાતાં\V_VAUX_VNP કે\CC_CCS બનતાં\V_VAUX_VNP નથી\RP_NEG .\RD_PUNC
GJRED922	શાસ્ત્રોએ\N_NN તો\RP_RPD આ\DM_DMD વાત\N_NN વારંવાર\PSP ,\RD_PUNC ઠેરઠેર\PSP ગાઈ\V_VAUX_VNP વગાડીને\V_VAUX_VNP કરી\V_VM છે\V_VAUX .\RD_PUNC
GJRED923	તેથી\PSP તેનું\DM_DMD રહસ્ય\N_NN સમજાતું\V_VAUX_VNP નથી\RP_NEG .\RD_PUNC
GJRED924	ધર્મ\N_NN એ\DM_DMD એક\QT_QTC અદ્દભુત\JJ તત્ત્વ\N_NN છે\V_VAUX .\RD_PUNC
GJRED925	વસ્તુત:\PSP તો\RP_RPD જેના\PR_PRL થકી\PSP સમજણદશા\N_NN ઉઘડે\V_VM તેનું\DM_DMD જ\RP_RPD નામ\N_NN ધર્મ\N_NN છે\V_VAUX .\RD_PUNC
GJRED926	આવો\JJ ધર્મ\N_NN એ\DM_DMD માત્ર\RP_RPD જાણવાનો\V_VAUX_VNP કે\CC_CCS કરી\V_VM બતાવવાનો\V_VAUX_VNP વિષય\N_NN નથી\RP_NEG રહેતો\V_VAUX_VNP પરંતુ\CC_CCD સમજવાનો\V_VAUX_VNP તથા\CC_CCD અનુભવવાનો\V_VAUX_VNP વિષય\N_NN બને\V_VM છે\V_VAUX .\RD_PUNC
GJRED927	ધર્મતત્ત્વનો\N_NN આવો\JJ અનુભવ\N_NN ,\RD_PUNC મનુષ્યને\N_NN નમ્ર\JJ ,\RD_PUNC હળવો\JJ ,\RD_PUNC સરલ\JJ અને\CC_CCD અનાગ્રહી\JJ બનાવે\V_VM છે\V_VAUX .\RD_PUNC
GJRED928	રોજિંદા\JJ -\RD_PUNC સામાન્ય\JJ વ્યવહારમાં\N_NN કે\CC_CCS પછી\PSP કોઈક\DM_DMI ખાસ\JJ બાબતમાં\N_NN પણ\RP_RPD ,\RD_PUNC પછી\PSP ,\RD_PUNC તે\DM_DMD વ્યક્તિ\N_NN પોતાની\PR_PRF માન્યતા\N_NN ,\RD_PUNC સમજણ\N_NN ,\RD_PUNC જિદ\N_NN કે\CC_CCS આગ્રહને\N_NN વળગી\V_VM નથી\RP_NEG રહેતી\V_VAUX_VNP .\RD_PUNC
GJRED929	તેનાથી\DM_DMD સાવ\PSP વિપરીત\JJ બને\V_VM તો\CC_CCD પણ\RP_RPD શાંત\JJ ભાવે\N_NN તેનો\DM_DMD સ્વીકાર\N_NN તે\DM_DMD કરી\V_VM શકે\V_VAUX છે\V_VAUX .\RD_PUNC
GJRED930	ધૈર્ય\N_NN ન\RP_NEG શીખવે\V_VM તે\DM_DMD ધર્મ\N_NN શાનો\PR_PRQ ?\RD_PUNC
GJRED931	અધીરા\JJ અને\CC_CCD હઠીલા\JJ બનાવે\V_VM તેને\DM_DMD ધર્મ\N_NN કેમ\DM_DMQ ગણાય\V_VM ?\RD_PUNC
GJRED932	ચિંતનનો\N_NN દોર\N_NN પછી\PSP તો\RP_RPD બહુ\QT_QTF લંબાયો\V_VM .\RD_PUNC
GJRED933	જૈન\JJ મુનિનું\N_NN મને\PR_PRP મળેલું\V_VAUX_VNP પદ\N_NN એ\DM_DMD ક્ષણે\N_NN સાંભર્યું\V_VM .\RD_PUNC
GJRED934	જૈન\JJ મુનિપદ\N_NN એટલે\PSP જીવંત\JJ જયણા\N_NN .\RD_PUNC
GJRED935	જૈન\JJ મુનિની\N_NN એક\QT_QTC એક\QT_QTC ક્રિયા\N_NN અને\CC_CCD ચેષ્ટા\N_NN તથા\CC_CCD પ્રવૃત્તિ\N_NN ,\RD_PUNC બીજા\JJ જીવોની\N_NN રક્ષા\N_NN માટે\PSP જ\RP_RPD હોય\V_VAUX .\RD_PUNC
GJRED936	બીજા\JJ જીવનને\N_NN હાનિ\N_NN પહોંચે\V_VM એવી\JJ એક\QT_QTC પણ\RP_RPD કાર્યવાહી\N_NN જૈન\JJ મુનિ\N_NN દ્વારા\PSP ન\RP_NEG થાય\V_VM ,\RD_PUNC ન\RP_NEG થવી\V_VAUX_VNP જોઈએ\V_VAUX .\RD_PUNC
GJRED937	જૈન\JJ મુનિ\N_NN પોતાના\PR_PRF માટે\PSP ન\RP_NEG જીવે\V_VM ,\RD_PUNC બીજાને\JJ જીવવા\V_VAUX_VNP દેવા\V_VAUX_VNP ખાતર\PSP પણ\RP_RPD ન\RP_NEG જીવે\V_VM .\RD_PUNC
GJRED938	જૈન\JJ મુનિ\N_NN જીવે\V_VM તો\CC_CCD અન્યને\JJ બચાવવા\V_VAUX_VNP માટે\PSP જીવે\V_VM .\RD_PUNC
GJRED939	આપણે\PR_PRP ત્યાં\N_NST પેલું\DM_DMD સૂત્ર\N_NN ભલે\PSP પ્રચલિત\N_NN બન્યું\V_VM :\RD_PUNC `\RD_PUNC જીવો\V_VM અને\CC_CCD જીવવા\V_VAUX_VNP દો\V_VM `\RD_PUNC .\RD_PUNC
GJRED940	પણ\CC_CCD એ\DM_DMD સૂત્ર\N_NN અધૂરું\JJ છે\V_VAUX .\RD_PUNC
GJRED941	બરાબર\JJ નથી\RP_NEG .\RD_PUNC
GJRED942	જૈન\JJ માર્ગનું\N_NN સૂત્ર\N_NN આવું\JJ હોય\V_VAUX ,\RD_PUNC `\RD_PUNC જીવો\V_VM અને\CC_CCD જીવાડો\V_VM `\RD_PUNC .\RD_PUNC
GJRED943	`\RD_PUNC જીવાડવા\V_VAUX_VNP માટે\PSP અથવા\CC_CCD બચાવવા\V_VAUX_VNP માટે\PSP જીવો\V_VM `\RD_PUNC .\RD_PUNC
GJRED944	કારણકે\CC_CCS બીજાને\JJ બચાવવામાં\V_VAUX_VNP જ\RP_RPD પોતાનો\PR_PRF બચાવ\N_NN હોય\V_VAUX છે\V_VAUX .\RD_PUNC
GJRED945	આ\DM_DMD તત્ત્વ\N_NN જેને\PR_PRL સમજાય\V_VM અને\CC_CCD જેના\PR_PRL આચરણમાં\N_NN આવે\V_VM ,\RD_PUNC તે\DM_DMD જૈન\JJ મુનિ\N_NN .\RD_PUNC
GJRED946	કદાચ\PSP આ\DM_DMD જ\RP_RPD કારણે\PSP આપણા\PR_PRP શાસ્ત્રકારે\N_NN ફરમાવેલું\V_VAUX_VNP કે\CC_CCS મુનિની\N_NN પ્રવૃત્તિ\N_NN પરહિતકારી\N_NN અને\CC_CCD તેથી\PSP નિજનો\PR_PRF કર્મક્ષય\N_NN કરનારી\V_VAUX_VNP જ\RP_RPD હોય\V_VAUX .\RD_PUNC
GJRED947	અર્થાત્\PSP મુનિ\N_NN જે\PR_PRL કરે\V_VM ,\RD_PUNC તેનાથી\DM_DMD તેનાં\DM_DMD કર્મો\N_NN ખપે\V_VM ,\RD_PUNC અને\CC_CCD અન્યનું\JJ હિત\N_NN થાય\V_VM જ\RP_RPD .\RD_PUNC
GJRED948	આટલું\JJ ચિંતન\N_NN થતાં\V_VAUX_VNP થતાં\V_VAUX_VNP તો\RP_RPD ખુશ\N_NN થઈ\V_VM જવાયું\V_VAUX .\RD_PUNC
GJRED949	જૈન\JJ મુનિપદ\N_NN પ્રત્યેનો\PSP અહોભાવ\N_NN હૈયે\N_NN ઝળહળી\V_VM ઊઠ્યો\V_VM .\RD_PUNC
GJRED950	તે\DM_DMD વાત\N_NN યાદ\V_VM આવતાં\V_VAUX_VNP જ\RP_RPD જીવ\N_NN આનંદના\N_NN રમણે\N_NN ચડી\V_VM ગયો\V_VAUX .\RD_PUNC
GJRED951	કેવું\DM_DMQ અદ્દભુત\JJ આ\DM_DMD પદ\N_NN !\RD_PUNC
GJRED952	કેવું\DM_DMQ ઉપકારી\JJ આ\DM_DMD શાસન\N_NN !\RD_PUNC
GJRED953	ધર્મ\N_NN અને\CC_CCD તેની\DM_DMD વિવિધ\JJ આરાધનાઓનું\N_NN સામાન્ય\JJ લક્ષ્ય\N_NN એક\QT_QTC જ\RP_RPD હોય\V_VAUX છે\V_VAUX .\RD_PUNC
GJRED954	મનને\N_NN સ્વચ્છ\JJ કરવાનું\V_VAUX_VNP .\RD_PUNC
GJRED955	ઘણી\QT_QTF ઘણી\QT_QTF ધર્મ\N_NN આરાધનાઓ\N_NN કરીએ\V_VM છતાં\RP_RPD મન\N_NN હજી\N_NST ચોખ્ખું\JJ નથી\RP_NEG થતું\V_VAUX_VNP .\RD_PUNC
GJRED956	તો\CC_CCD તેમાં\DM_DMD દોષ\N_NN કોનો\PR_PRQ ધર્મનો\N_NN ?\RD_PUNC
GJRED957	દોષ\N_NN આરાધનાનો\N_NN ?\RD_PUNC
GJRED958	દોષ\N_NN ક્રિયાનો\N_NN ?\RD_PUNC
GJRED959	ના\RP_NEG ,\RD_PUNC દોષ\N_NN આપણો\PR_PRP જ\RP_RPD .\RD_PUNC
GJRED960	ધર્મ\N_NN કરવાનો\V_VAUX_VNP છે\V_VAUX ,\RD_PUNC મનમાં\N_NN વર્તતી\V_VAUX_VNP મલિનતાઓને\N_NN પખાળવા\V_VAUX_VNP માટે\PSP .\RD_PUNC
GJRED961	મલિન\JJ મન\N_NN જેનાથી\PR_PRL ઊજળું\JJ થાય\V_VM તે\DM_DMD જ\RP_RPD છે\V_VAUX ધર્મ\N_NN .\RD_PUNC
GJRED962	ધર્મ\N_NN કરવા\V_VAUX_VNP છતાં\RP_RPD આપણું\PR_PRP મન\N_NN મલિનતાથી\N_NN છૂટતું\V_VAUX_VNP ન\RP_NEG હોય\V_VAUX તો\CC_CCD આપણે\PR_PRP આપણા\PR_PRP મનની\N_NN જ\RP_RPD ખણખોદ\N_NN કરવી\V_VAUX_VNP જ\RP_RPD પડે\V_VM .\RD_PUNC
GJRED963	આવી\JJ ખણખોદ\N_NN જેને\PR_PRL ગમે\V_VM ,\RD_PUNC તેને\DM_DMD દૂર\JJ કરવાની\V_VAUX_VNP તમન્ના\N_NN જેને\PR_PRL જાગે\V_VM ,\RD_PUNC તેનું\PR_PRP નામ\N_NN ધર્મી\JJ જીવ\N_NN .\RD_PUNC
GJRED964	અપેક્ષા\N_NN પાપમાં\N_NN પરોવે\V_VM છે\V_VAUX .\RD_PUNC
GJRED965	અપેક્ષા\N_NN આનંદને\N_NN નષ્ટ\JJ કરે\V_VM છે\V_VAUX .\RD_PUNC
GJRED966	અપેક્ષાને\N_NN કારણે\PSP રૂડા\JJ સંબંધો\N_NN પણ\RP_RPD તૂટે\V_VM છે\V_VAUX .\RD_PUNC
GJRED967	અપેક્ષા\N_NN હલકા\JJ -\RD_PUNC હીણા\JJ જનોની\N_NN લાચારી\N_NN કરાવે\V_VM છે\V_VAUX .\RD_PUNC
GJRED968	ટૂંકમાં\N_NN ,\RD_PUNC અપેક્ષા\N_NN દરેક\JJ પ્રકારનાં\N_NN દુ:ખોની\N_NN જનેતા\N_NN બની\V_VM રહે\V_VAUX છે\V_VAUX .\RD_PUNC
GJRED969	બીજી\JJ મલિનતાનું\N_NN નામ\N_NN છે\V_VAUX અભિમાન\N_NN .\RD_PUNC
GJRED970	આવું\JJ અભિમાન\N_NN આપણને\PR_PRP કનડતું\V_VAUX_VNP હોય\V_VAUX છે\V_VAUX .\RD_PUNC
GJRED971	ખાસ\JJ દેખાવાની\V_VAUX_VNP અને\CC_CCD બીજા\JJ ઉપર\PSP પ્રભાવ\N_NN પાડવાની\V_VAUX_VNP વૃત્તિને\N_NN લીધે\PSP પેદા\JJ થતું\V_VAUX_VNP આ\DM_DMD અભિમાન\N_NN આપણને\PR_PRP તુચ્છ\JJ પણ\RP_RPD બનાવે\V_VM છે\V_VAUX .\RD_PUNC
GJRED972	પોતાની\PR_PRF જાતે\PR_PRF જ\RP_RPD હલકા\JJ થવાની\V_VAUX_VNP જોગવાઈ\N_NN આ\DM_DMD અભિમાન\N_NN પૂરી\JJ પાડે\V_VM છે\V_VAUX .\RD_PUNC
GJRED973	આ\DM_DMD અભિમાન\N_NN જ\RP_RPD આપણને\PR_PRP આપણા\PR_PRP જ\RP_RPD માણસોથી\N_NN વિખૂટા\JJ પાડી\V_VM દે\V_VAUX છે\V_VAUX .\RD_PUNC
GJRED974	આપણા\PR_PRP દ્વારા\PSP કોઈનું\PR_PRI ખરાબ\JJ કરવાની\V_VAUX_VNP ભૂમિકા\N_NN પણ\RP_RPD એ\DM_DMD પૂરી\JJ પાડે\V_VM છે\V_VAUX .\RD_PUNC
GJRED975	ક્રોધ\N_NN ,\RD_PUNC અસત્ય\N_NN ,\RD_PUNC પ્રપંચ\N_NN અને\CC_CCD દ્વેષ\N_NN જેવાં\JJ મલિન\JJ તત્ત્વોનું\N_NN ઉદ્દભવસ્થાન\N_NN પણ\RP_RPD આ\DM_DMD અભિમાન\N_NN જ\RP_RPD હોય\V_VAUX છે\V_VAUX .\RD_PUNC
GJRED976	સંબંધોમાં\N_NN કડવાશ\N_NN અને\CC_CCD પછી\PSP વિચ્છેદ\N_NN એ\DM_DMD આનું\DM_DMD ભયાનક\JJ પરિણામ\N_NN છે\V_VAUX .\RD_PUNC
GJRED977	અદેખાઈ\N_NN એ\DM_DMD ત્રીજી\JJ મલિનતા\N_NN છે\V_VAUX .\RD_PUNC
GJRED978	આવી\JJ વ્યક્તિ\N_NN કોઈનું\PR_PRI સારું\JJ ન\RP_NEG જોઈ\V_VM શકે\V_VAUX ,\RD_PUNC ન\RP_NEG ખમી\V_VM શકે\V_VAUX .\RD_PUNC
GJRED979	એને\PR_PRP અન્યની\JJ સારપમાં\N_NN પણ\RP_RPD બૂરાઈ\N_NN જ\RP_RPD શોધવી\V_VAUX_VNP ગમશે\V_VM .\RD_PUNC
GJRED980	કોઈનું\PR_PRI સારું\JJ થાય\V_VM કે\CC_CCS બોલાય\V_VM તો\CC_CCD તેના\PR_PRP પેટમાં\N_NN તેલ\N_NN જ\RP_RPD રેડાવાનું\V_VAUX_VNP .\RD_PUNC
GJRED981	સરવાળે\PSP આવો\JJ માણસ\N_NN બધી\QT_QTF રીતે\N_NN સુખી\JJ હોય\V_VAUX તોય\RP_RPD તે\PR_PRP અત્યંત\JJ દુ:ખી\JJ જ\RP_RPD હોવાનો\V_VAUX_VNP .\RD_PUNC
GJRED982	આપણી\PR_PRP તમામ\JJ ધર્મકરણી\JJ આ\DM_DMD મલિનતાઓને\N_NN નાબૂદ\JJ કરવાનું\V_VAUX_VNP સરસ\JJ સાધન\N_NN બની\V_VM રહે\V_VAUX તે\DM_DMD રીતે\N_NN કરવાનો\V_VAUX_VNP હવે\N_NST નિર્ધાર\N_NN કરીશું\V_VM ?\RD_PUNC
GJRED983	ગુરુની\N_NN કૃપા\N_NN અને\CC_CCD શિષ્યનું\N_NN સમર્પણ\N_NN -\RD_PUNC એ\DM_DMD બે\QT_QTC વાનાં\N_NN ભેગાં\JJ મળે\V_VM તો\CC_CCD ધારેલાં\V_VAUX_VNP જ\RP_RPD નહિ\RP_NEG ,\RD_PUNC પણ\CC_CCD અણધાર્યા\JJ પણ\RP_RPD રૂડાં\JJ ફળ\N_NN નીપજી\V_VM આવે\V_VAUX .\RD_PUNC
GJRED984	સમર્પિત\JJ શિષ્ય\N_NN સાંપડવા\V_VAUX_VNP એ\DM_DMD બધા\QT_QTF ગુરુના\N_NN નસીબમાં\N_NN નથી\RP_NEG હોતા\V_VAUX_VNP .\RD_PUNC
GJRED985	પોતાની\PR_PRF ઈચ્છા\N_NN અને\CC_CCD પોતાના\PR_PRF અભિપ્રાય\N_NN -\RD_PUNC બન્નેને\JJ ગુરુચરણમાં\N_NN વિસર્જિત\JJ કરવા\V_VAUX_VNP જોઈએ\V_VAUX .\RD_PUNC
GJRED986	આવા\JJ શિષ્ય\N_NN ક્વચિત\PSP જ\RP_RPD અને\CC_CCD કોઈકને\PR_PRI જ\RP_RPD સાંપડતા\V_VAUX_VNP હોય\V_VAUX છે\V_VAUX .\RD_PUNC
GJRED987	ગુરુ\N_NN તો\RP_RPD પાત્ર\JJ -\RD_PUNC અપાત્ર\JJ જોયા\V_VAUX_VNP વિના\PSP ,\RD_PUNC સમાન\JJ ભાવે\N_NN -\RD_PUNC સમ\JJ ભાવે\N_NN ,\RD_PUNC શિષ્યનું\N_NN કલ્યાણ\N_NN વાંછતા\V_VAUX_VNP અને\CC_CCD કરતા\V_VAUX_VNP જ\RP_RPD રહે\V_VAUX .\RD_PUNC
GJRED988	`\RD_PUNC મને\PR_PRP સમર્પિત\JJ શિષ્યો\N_NN મળો\V_VM `\RD_PUNC એવી\JJ લાલસા\N_NN ગુરુમાં\N_NN ન\RP_NEG હોય\V_VAUX તે\DM_DMD સમજાય\V_VM એવું\JJ છે\V_VAUX .\RD_PUNC
GJRED989	`\RD_PUNC ગુરુ\N_NN `\RD_PUNC શબ્દના\N_NN સામાન્ય\JJ રીતે\N_NN બે\QT_QTC અર્થ\N_NN થાય\V_VM છે\V_VAUX :\RD_PUNC ગુરુ\N_NN એટલે\PSP ગૌરવવંત\JJ ,\RD_PUNC ગુરુ\N_NN એટલે\PSP ભારે\JJ .\RD_PUNC
GJRED990	નિ:સ્પૃહી\JJ ,\RD_PUNC વત્સલ\JJ ,\RD_PUNC ગુણિયલ\JJ અને\CC_CCD સન્નિષ્ઠ\JJ સત્પુરુષ\N_NN હોય\V_VAUX તેને\DM_DMD પહેલો\JJ અર્થ\N_NN લાગુ\JJ પડે\V_VM .\RD_PUNC
GJRED991	એથી\PSP ઊલટી\JJ વ્યક્તિને\N_NN બીજો\JJ અર્થ\N_NN બંધબેસતો\V_VAUX_VNP આવે\V_VAUX .\RD_PUNC
GJRED992	શિષ્ય\N_NN પર\PSP અહેતુક\JJ -\RD_PUNC કશા\DM_DMI જ\RP_RPD બદલા\N_NN કે\CC_CCS વળતરની\N_NN અપેક્ષા\N_NN રાખ્યા\V_VAUX_VNP વિના\PSP જ\RP_RPD પ્રેમ\N_NN વરસાવે\V_VM તેવો\JJ પુરુષ\N_NN `\RD_PUNC ગુરુ\N_NN `\RD_PUNC પદ\N_NN માટે\PSP પૂરતો\JJ લાયક\JJ ગણાય\V_VM .\RD_PUNC
GJRED993	શિષ્યને\N_NN મર્યાદાનું\N_NN પાલન\N_NN ઝટ\RB નથી\RP_NEG ગમતું\V_VAUX_VNP હોતું\V_VAUX .\RD_PUNC
GJRED994	જરા\QT_QTF જરામાં\QT_QTF વંકાય\V_VM પણ\CC_CCD ખરો\RP_RPD ,\RD_PUNC અને\CC_CCD જરાક\QT_QTF અમથું\QT_QTF આવડી\V_VM જાય\V_VAUX તો\CC_CCD તેનો\DM_DMD ફુગ્ગો\N_NN ફૂલે\V_VM અને\CC_CCD કવચિત્\PSP ફાટે\V_VM પણ\RP_RPD ખરો\RP_RPD .\RD_PUNC
GJRED995	ગુરુનું\N_NN કામ\N_NN આવે\V_VM સમયે\N_NN ,\RD_PUNC સામેના\JJ પાત્રની\N_NN ભૂમિકા\N_NN પ્રમાણે\PSP ,\RD_PUNC કઠોર\JJ થયા\V_VAUX_VNP વિના\PSP કે\CC_CCS થઈને\V_VAUX_VNP ,\RD_PUNC તેવા\JJ શિષ્યને\N_NN ઠેકાણે\JJ લાવવાનું\V_VAUX_VNP હોય\V_VAUX છે\V_VAUX .\RD_PUNC
GJRED996	હૈયે\N_NN હિતની\N_NN જ\RP_RPD માત્ર\RP_RPD કલ્પના\N_NN હોય\V_VAUX છે\V_VAUX .\RD_PUNC
GJRED997	આમ\PSP કરવા\V_VAUX_VNP જતાં\V_VAUX_VNP ઘણી\QT_QTF વાર\N_NN નિષ્ફળતા\N_NN પણ\RP_RPD સાંપડે\V_VM .\RD_PUNC
GJRED998	શિષ્ય\N_NN હું\PR_PRP પદ\N_NN કે\CC_CCS અવિવેક\N_NN ન\RP_NEG પણ\RP_RPD છોડે\V_VM ,\RD_PUNC અને\CC_CCD પોતાના\PR_PRF અહિતકારી\JJ -\RD_PUNC અવિચારી\JJ વર્તન\N_NN પર\PSP અડ્યો\V_VM જ\RP_RPD રહે\V_VM એવું\JJ પણ\RP_RPD બને\V_VM .\RD_PUNC
GJRED999	આવે\JJ વખતે\N_NN પણ\RP_RPD ધીરજ\N_NN ન\RP_NEG હારે\V_VM ,\RD_PUNC હિતકામનામાં\N_NN પીછેહઠ\N_NN ન\RP_NEG કરે\V_VM ,\RD_PUNC તેનું\DM_DMD નામ\N_NN ગુરુ\N_NN .\RD_PUNC
GJRED1000	એથી\PSP સાવ\PSP ઊલટું\JJ ,\RD_PUNC '\RD_PUNC ધર્મ\N_NN '\RD_PUNC એ\DM_DMD એટલા\JJ માટે\PSP આપણી\PR_PRP વસ્તુ\N_NN છે\V_VAUX કે\CC_CCS તેના\DM_DMD પર\PSP આપણી\PR_PRP માલિકી\N_NN છે\V_VAUX .\RD_PUNC 